faarm	புர்ம்
farm	புரம்
form	ணர்ப்
hpaarm	புரம்
face	பெய்
hpaes	பீஷ்
pace	பெய்
paes	பெஷ்
phase	ஷண்
aeathimuka	ஆதிமுக்
aiathimuka	அயதிமுக்
ayiathimuka	அயாதியுக்க
agaththi	அகத்தி
akaththi	அகத்தி
agaththikkeerai	அகத்திரிக்கை
akaththikkeerai	அகத்திக்கியை
agamadhabaath	அகாதாதத்
agamathaabaath	அகாதாதாத்
ahamadabad	அகாாதத்
ahemadaabad	அஹேகாதாத்
ahmadabad	அகாமதாத்
ahmedabad	அமீபடதத்
akamatapat	அகாமாடத்
agamadhabaatthil	அகாாதததததி
agamathaabaaththil	அகாமாததததிதில்
ahmadabadil	அகாமத்தாபி
ahmedabadil	அமீபாடததி
ahmedabadthil	அமேகாத்ததிப்
agazhaaivil	அகாவேலில்
agazhaayvil	அகாவேலில்
akalvaaivil	அகாவ்வாவிலி
akazhaayvil	அகாவாவில்
akazhvaaivil	அகழ்வாவிலில்
ahimsai	அமிச்சை
akimsai	அமிச்சை
angkeegariththu	அங்கேரித்திது
angkeekariththu	அங்கேரியத்து
angkeegariththullathu	அங்கேரியத்தில்து
angkeekariththullathu	அங்கேரியத்தில்த்து
angkeegaarangkal	அங்கீராகனககக்
angkeekaarangkal	அங்கீராகங்கக்
angkeegaaraththaip	அங்கீகாரத்தைப்
angkeekaaraththaip	அங்கீகாரத்தைப்
asaiyaa	அசையா
ashokan	அசோகன்
asokan	சோகனன்
achoakaa	அசோகா
ashok	அசுச்
ashoka	அசோக்
ashokaa	அசோக்
asok	சோசு
asoka	அசோக்
asokaa	அசோக
asook	சசூன்
asooka	சசோன்
asookaa	அசோக்
asoq	சசு
asoqa	அசோக்
asoqaa	அசோக்
adakki	டடக்கி
adakkik	அடக்கிக்
adainkiya	அடைக்கிய
adangiya	அடங்கிய
adankiya	அடங்கிய
adanggiyadhu	அடங்கியது
adanggiyathu	அடங்கியது
adangiyadhu	அடங்கியது
adangiyathu	அடங்கியது
adankiyathu	அடங்கியது
adangiyulla	அடங்கியுள்ள
adangkiyulla	அடங்கியுள்ள
adankiyuzhzha	அடங்கிழுவ்
pidiththu	பிடித்து
pitittu	பிடிட்டு
aada	அய்டா
aadaa	ஆடா
ada	அட்யா
adaa	நாதா
manadhil	மனித்தில்
manathil	மனித்தில்
manatil	மனித்தில்
adigalum	அடிகளும்
adihalum	அதியலும்
adikalum	அடிகளும்
adigalaiyum	அடிகளையும்
adigalayum	அடிகளையும்
adikalaiyum	அடிகளையும்
adikalayum	அடிகளையும்
adikkadi	அடிக்கடி
adikkadik	அடிக்கடித்
adikku	அடிக்கு
adith	அடித்து
adiyilirundhu	அடியிலிருந்து
adiyilirunthu	அடியிலிருந்து
adiyilum	அடியிலும்
adiyum	அடியும்
atiyum	அறியும்
adiyai	அடியை
atiyai	அடியை
aduththum	அடுத்தும்
aduthum	அடுத்தும்
adutthum	அடுத்தும்
adaithal	அடைத்தல்
ataithal	அடைத்தல்
attooliyangalum	அட்டோலியங்கும்
attoozhiyangalum	அட்டோலியினகும்
attoozhiyanggalum	அட்டோலியாங்கும்
andar	அண்டர்
antar	அண்டர்
under	அண்டுர்
annan	னனன்
adhanadhan	அதனதன்
adhanathan	அதனதன்
athanathan	அதனதன்
adhanudan	அனதுடன்
athanudan	அனதுடன்
adhaavadhu	அதவாது
adhavadhu	அவதுது
athaavathu	அதவாது
athavathu	அதவது
adhigappadiyaaga	அதிகப்பியடாக
athigappadiyaaga	அதிகப்பியடாக
athikappatiyaaka	அதிகப்பியடாக
adhikamaanathu	அதிகானமது
athigamaanathu	அதிகானதது
athikamaanathu	அதிகாமனது
adhidhi	அதித்தி
adiiti	டெடித்தி
adiitii	டெடித்தி
adiittii	டெடித்தி
aditi	அடித்தி
aditii	அடித்தி
aditti	அடித்தி
athithi	அதித்தி
atiti	அடித்தி
adhiradi	அதிரடி
athiradi	அதிரடி
adhirvu	அதிருவ்
athirvu	அதிருவ்
adhirvukaly	அதிருவ்களை
athirvukalai	அதிருவ்களை
athirvukalay	அதிருவ்களை
athirvugal	அதிருவ்கள்
athirvukal	அதிருவ்கள்
adhilum	அதிலும்
athillum	அதிலும்
athilum	அதிலும்
adhilaeyae	அதிலையே
adhileye	அதிலேயே
athilaeyae	அதியேலே
athileye	அதிலே
adheedhamaana	அதேதமான
adhidhamana	அதிதமான
atheethamaana	அதேதமான
athithamana	அதிதமான
adhaepoal	அதேபோல்
ateepool	அத்தோப்ப்
atepol	அட்சொல்
athaepool	அதேபோல்
aththiyaayangalil	அத்தியானைகளில்
aththiyaayangkalil	அத்தியானைகளில்
aththiyaayangalai	அத்தியாயங்களை
aththiyaayangkalai	அத்தியாயங்களை
aththiyaayangal	அத்தியாயனகள்
aththiyaayangkal	அத்தியாயங்கள்
aththiyaayaththin	அத்தியாதயத்தின்
aththiyaayaththil	அத்தியாயத்தில்
aththiyaayam	அத்தியாயம்
andhak	அந்துக்
andhakh	அந்தது
anthak	அந்துக்
andhandha	அந்தந்த
anthantha	அந்தந்த
andhoni	அந்தோன்
anthoni	அந்தோன்
anthony	அந்தோன்
antony	அந்தோன்
ananrtham	அனந்தம்
anarththam	அனர்த்தம்
aneeta	அநேத்
aneetaa	அநீதா
aniita	அணிய்த
aniitaa	அணியாத
anita	அணித்த
anitaa	அணியாத
anitha	அனித்த
anithaa	அனிதா
anubama	அனுமம்
anubamaa	அனுமாப
anupama	அனும்ப
anupamaa	அனுமாப
anubavika	அனுவாபிக்
anubavikka	அனுவவிக்க
anupavikka	அனுவாபிக்
anuppia	அனுப்பி
anuppiya	அனுப்பிய
anuppiyathu	அனுப்பியது
anuraadhapuraththil	அனுராதபுதாரித்தில்
anuraathapuraththil	அனுராதமுறத்தில்
anuradhapuraththil	அனுரதப்பாரததில்
anurathapuraththil	அனுரதுபாரத்தில்
anuraathapuram	அனுராதப்புறம்
anuradhapuram	அனுரதப்பாரும்
anurathapuram	அனுரதப்புறம்
anniya	அனியா
anbai	அன்பை
anbaip	அண்பைப்
anpaip	அன்பைப்
anbaiyum	அண்பையும்
andri	அன்றி
antri	அன்றி
andriravu	அன்றிவரு
antriravu	அன்றிவரு
abinaya	அபினாய்
apinaya	அபிணாய்
abudhabiyil	அபுதபிியில்
abuthaabiyil	அபுதாபியில்
abul	அபுசல்
aboorvamaana	அப்வுமான
aburvamaana	அருப்வானான
apoorvamaana	அப்புவானார்
appagudhi	அப்பகுதி
appaguthi	அப்பகுதி
appakuthi	அப்பகுதி
appaguthigalil	அப்பகுதிகளில்
appaguthikalil	அப்பகுதிகளில்
appakuthikalil	அப்பகுதிகளில்
appaguthikku	அப்பாகித்துக்
appakuthikku	அப்பகுதிக்கு
appaguthiyin	அப்பகுதியின்
appakuthiin	அப்பகுதின்
appakuthiyin	அப்பகுதியின்
appadaththil	அப்படத்தில்
appadatthil	அப்படத்தில்
appadaththai	அப்படத்தை
appadatthai	அப்படத்தை
appadiyaanaal	அப்படியானான
appaadal	அப்பாடல்
appaatal	அப்பாட்டல்
apengal	அபெங்கல்
apenkal	அபெங்கல்
appenkal	அப்பெங்கள்
appoluthu	அப்போலுத்து
appozhudhu	அப்போழுது
appozhuthu	அப்போழுது
americar	அமீரிக்கா்
amerikkar	அமீரிக்கார்
amerikkargalukku	அமேரிக்கக்களுக்கு
amerikkarkalukku	அமேரிக்கக்களுக்கு
amerikkargal	அமீரிக்கார்கள்
amerikkarkal	அமீரிக்கார்கள்
amaerikka	அமேரிக்க
amarica	அமரிச்
amaricaa	அமரிக்கா
amarika	அமரிக்
amarikaa	அமரிகா
america	அமீரிய்
americaa	அமீரியா
amerika	அமீரிக்
amerikaa	அமீரிகா
amerikka	அமேிரிக்
ameriqa	அமீரிக்
ameriqaa	அமீரிகா
americaavirku	அமேரியாவிர்கு
americavirkku	அமேரிய்கார்குக்
americavirku	அமரியிகர்வுக்
amerikkaavirku	அமேரிக்காவிற்கு
americaavil	அமேரிக்சாவில்
americavil	அமரிக்ஜிவில்
amerikkaavil	அமேரிக்காவில்
americaavukku	அமேரிசாகிகுவு
americavukku	அமெரியக்குவுக்
amerikkaavukku	அமேரிக்காவகுக்
americaavai	அமரியாசாவி
americavai	அமரிய்சவை
amerikkaavai	அமேரிக்கவை
amaichchup	அமைச்சுப்
amaiththu	அமைத்து
amaithu	அமைத்து
amaitthu	அமைத்து
amaiththuth	அமைத்துத்
amaithuth	அமைத்துத்
amaitthuth	அமைத்துத்
amachankalil	அமச்சங்களில்
amasankalil	அமச்சங்களில்
amsangalil	அம்சங்களில்
amsangkalil	அம்சங்களில்
amchankalum	அம்சங்களும்
amsangalum	அம்சங்களும்
amsankalum	அம்சங்களும்
amsangalaik	அம்சங்களைக்
amsangazhaik	அம்சங்களைக்
amsanggalaik	அம்சங்களைக்
amsaththai	அம்சத்தை
amchamaana	அம்சமான
amchamana	அம்சமான
amsamaana	அம்சாமன்
ambalavaanar	அம்பவளான்
ambalavanar	அம்பவளான்
ampalavaanar	அம்பவளானர்
ayana	யனான
ayirai	யயரி
airoappiya	ஐரோப்பிய
airoopiya	அரோப்யை
airoppiya	ஐரோப்பிய
ayrooppiya	அறைப்போய்
ayropiya	யறோபியா
europe	யரோப்
arakka	அரக்கு
arrakka	ரரக்க
arakkan	அரக்கன்
arrakkan	ரரக்கான்
arakku	அரக்கு
araku	ஊரகு
aruppukkoattai	அறுப்புக்கோட்ட
aruppukkoottai	அறுப்புக்கோட்டி
aruppukkottai	அறுப்புக்கோட்ட
aruppukoattai	அறுப்புக்கோட்ட
arumbu	அமுற்பு
arppaniththa	அற்ப்பணித்த
ariyappatta	அறியப்பட்ட
ariyappattadhu	அறியப்பட்டது
ariyappattathu	அறியப்பட்டது
ariyappattu	அறியப்பட்டு
ariyaar	அறியார்
ariyum	அறியும்
arivadhu	அறிவது
arivathu	அறிவது
arivan	அறிவன்
arivin	அறிவின்
arivar	அறிவர்
arivin	அறிவின்
arivippugalai	அறிவிப்புகளை
arivippukalai	அறிவிப்புகளை
arivil	அறிவில்
arivulla	அறிவுள்ள
arupathaam	அறுபதாம்
arupathugalil	அருபதுதலில்
arupathukalil	அருபதுகளில்
arupaththu	அறுபதுத்
aupaththu	ஆபதுத்
araiguuval	அறைகுவுல்
araikooval	அறைகோவல்
araikuuval	அறைகுவுல்
alagaal	அழகால்
alakaal	அழகால்
alagil	அழகில்
alakil	அளகில்
aliyum	அழியும்
alavaal	அவலால்
alavukadandhdha	அலவுகாணத்த
alavukadandhtha	அலவுகாணத்த
alavukadantha	அலவுகாட்டன்
alavukatandhdha	அலவுகா்தட்ட
alavukatandhtha	அலவுகா்தட்ட
alavugalum	அவலுக்கும்
alavukalum	அழவுகளும்
alavugalai	அவுகளை
alavukalai	அழவுகளை
alavugal	அவுகள்
alavukal	அவுகள்
alavukkuch	அவலுக்குச்
alavukkup	அவழுக்குப்
alavukkum	அழவுக்கும்
alavulla	அவலுள்ள
alagi	அழக்கி
alaki	அழக்கி
azhagi	அழக்சி
azhaki	அழக்கு
alaginai	அழகினை
alakinai	அழகினை
alazhaginai	அழகனிச்
azhaginai	அழகினை
azhakinai	அழகினை
alagin	அழிக்
alakin	அழகின்
azhagin	அழகின்
azhakin	அழகின்
alakiyaana	அழகியான
alazhagiyaana	அழகசியான
azhagiyaana	அழகியான
azhakiyaana	அழகியான
alagil	அழகில்
alakil	அளகில்
azhagil	அழகில்
azhakil	அழகில்
azhiththadhu	அழித்தது
azhiththathu	அழித்தது
azhiththana	அழித்தன
azhiththanar	அழித்தனர்
azhiththavan	அழித்தவன்
aliththaan	அளித்தான்
azhiththaan	அழித்தான்
aliththaar	அளித்தார்
azhiththaar	அழித்தார்
aluththi	அழுத்தி
azhuththi	அழுத்தி
alaippu	அழைப்பு
azhaippu	அழைப்பு
avathaaranggalil	அவதாரங்களில்
avathaarangkalil	அவதாரங்களில்
avathaaranggal	அவதாரங்கள்
avathaarangkal	அவதாரங்கள்
avathaaraththil	அவராதத்தில்
avatar	அவட்டர்
avathaar	அவதார்
avanudaiya	அவனுடைய
avaridam	அவரிடம்
avatrtrudan	அவற்றுடன்
avatrudan	அவற்றுடன்
avattrudan	அவற்றுடன்
avalukku	அவலுக்கு
avaludan	அவலுடன்
availaik	அவையில்
avalaik	அவளைக்
avalaith	அவளைத்
avalaip	அவளைப்
avvagai	அவ்வாக்
avvakai	அவ்வாக்
aagast	ஆக்ச்
aagust	ஹாக்கு
aakast	ஆக்ச்
agast	கச்த்
august	கசுத்து
auuguust	கூசுந்து
avgast	அவ்காத்
awgast	ஹவ்காத்
aagivida	ஆகிவிட்
aagivita	ஆகிவிட்
aakivida	ஆகிவிட்
aagividum	ஆகிவிடும்
aagivitum	ஆகிவித்தும்
aakividum	ஆகிவிடும்
aaakspoard	ஆக்ச்போர்டு
aaksfoard	ஆக்ஸ்போர்டு
aakspoard	ஆக்ச்போர்டு
oxford	கோப்ரூர்
aasiramaththirku	ஆசியரத்திருத்
aasiramaththiruku	ஆசிரமிதத்திற்கு
aasiramaththil	ஆசிரமத்தில்
aachiramam	ஆசிரமாம்
aashram	ஆர்சும்
aasiramam	ஆசிரமம்
aasram	ஆர்சும்
ashram	அச்சிரம்
ashramm	ஆச்சமிம்
asram	ச்சரும்
asramm	ஆஸ்மரும்
aasiriyaraakap	ஆசிரியராகப்
assiriyaraagap	அசிசிராயபாக
aasiriyaraakavum	ஆசிரியராகவும்
assiriyaraagavum	சசிரியராகவும்
aanchchanaeyar	ஆன்சன்சர்
aanjaneayar	ஆன்சனேசிய
aanjchanaeyar	ஆஞ்சனியர்
anjaneyar	அஞ்சநேயர்
aadippoora	ஆடிப்போர்
aadippooram	ஆடிப்போரம்
aadugalil	ஆடுகளில்
aadukalil	ஆடுகளில்
aadubavar	ஆடுவர்
aadupavar	ஆடுவர்
aadum	ஓடும்
aaduvar	ஆடுவர்
aatti	ஆட்டி
aattin	ஆட்டின்
aangalidam	ஆங்களியம்
aangalitam	ஆங்களியம்
aankalitam	ஆங்களியம்
aangalin	ஆங்களின்
aankalin	ஆங்களின்
aangalilum	ஆங்களிலும்
aankalilum	ஆங்களிலும்
aangalukkaana	ஆங்களுக்கான
aangalum	ஆங்களும்
aankalum	ஆங்களும்
aangalae	ஆங்களே
aankalae	ஆங்களே
aangalaik	ஆங்களைக்
aankalaik	ஆங்களைக்
aangak	ஆங்கு
aangal	ஆங்கு
aankal	ஆங்கு
aanda	ஆண்டு
aanta	அண்டு
aandathu	ஆண்டது
aantathu	ஆண்டது
aandanar	ஆண்டனர்
aantanar	ஆண்டனர்
aandarchan	ஆண்டரசன்
aandarsan	ஆண்டரசன்
andarshon	அண்டரசஷ்்
andarson	அண்டரசன்
anderson	அண்டரசஷ்்
aandavar	ஆண்டவர்
aantavar	ஆண்டவர்
aandilirunththu	ஆண்டிலிருந்து
aandilirunthu	ஆண்டிலிருந்து
aandae	ஆண்டே
aantae	ஆண்டே
aatharavaaga	ஆதரவாக
aatharavaaka	ஆதரவாக
aatharavaagach	ஆதரவாசக்
aatharavaakach	ஆதரவாசக்
aatharvaagach	ஆதர்வாசக்
aatharikkavillai	ஆதரிக்கவில்லை
aathmaa	ஆத்மா
aathmaavin	ஆத்மாவின்
aathmaavil	ஆத்மாவில்
aanthai	ஆந்தை
aanththai	ஆந்தை
aanaimalai	ஆணைமலை
aan	னை
aana	அனியா
ain	ையின்
ainn	யனன்
an	னை
ann	னின்
ein	னைப்
einn	னின்
en	னை
enn	னின்
on	னை
aanmaa	அன்மா
anema	அணமே
aniima	அணியம்
anima	அணிமம்
animaa	அணிமா
anma	அனம்
enima	நீயம்
aanmaavukku	ஆன்மாவிக்கு
aapirikkaa	ஆபிரிக்கா
africa	ஆப்ரிச்
aappirikkaavilum	ஆப்பிரிக்காவிலும்
aappirikkavilum	ஆப்பிரிக்கவிலும்
africaavilum	ஆப்ரிக்காவிலும்
aappirikkaavukku	ஆப்பிரிக்காவுக்கு
africaavukku	ஆப்ரியாவுக்கு
africavukku	ஆப்ரியாகுவுக்
aappirikkaavai	ஆப்பிரிக்காவை
africaavai	ஆரிப்காய்
africavai	ஆபிரியாச்
aayeena	யோனியா
aayina	ஆயின்
aayeenar	யேனதிர்
aayinar	ஆயினர்
aayera	யோரதி
aayira	ஆயிர்
aayerakkanakkil	ஆயற்ககங்களில்
aayirakkanakkil	ஆயிரகங்களில்
aayeraththirkum	ஏயரத்திருக்கும்
aayiraththirkum	ஆயர்திரத்தும்
aayeraththu	ஏயரத்து
aayiraththu	ஆயிரத்து
aayeraththai	ஏயரத்தை
aayiraththai	ஆயரித்தை
aayeram	ஆயரும்
aayiram	ஆயிரம்
ayil	ய்யில்
oial	யோலில்
oil	னைஸ்
oill	யூலில்
ouil	ரிய்ல்
ouuil	ரூவில்
oyal	யோயில்
aayulai	ஆயுவை
aaitha	யந்தா
aaytha	யந்த
aaivukalin	ஆய்வுகளின்
aayuvugalin	ஆயுவுகளின்
aayvugalin	ஆய்வுகளின்
aayvukalin	ஆய்வுகளின்
aaivukalukku	ஆய்வுகளுக்கு
aayvugalukku	ஆய்வுகளுக்கு
aayvukalukku	ஆய்வுகளுக்கு
aaivukalaiyum	ஆய்வுகளையும்
aayvugalaiyum	ஆய்வுகளையும்
aayvukalaiyum	ஆய்வுகளையும்
aaivukal	ஆவுக்கள்
aayvugal	ஆய்வுகள்
aayvukal	ஆய்வுகள்
aaivuk	ஆய்வுக்
aayvuk	ஆய்வுக்
aaivukkatturai	ஆய்வுக்குடத்தி
aayvukkatturai	ஆய்வுக்குட்டிய
aaivukkatturaikal	ஆய்வுக்குடத்திகள்
aayvukkatturaigal	ஆய்வுக்குடத்திகள்
aayvukkatturaikal	ஆய்வுக்குடத்திகள்
aaivukkaaaka	ஆய்வுகாக
aayvukkaaga	ஆய்வுக்காக
aayvukkaaka	ஆய்வுக்காக
aaivukkaana	ஆய்வுக்கான
aayvukkaana	ஆய்வுக்கான
aaivukku	ஆய்வுக்கு
aayvukku	ஆய்வுக்கு
aaivum	ஆய்வும்
aayvum	ஆய்வும்
aariyar	ஆரியர்
aariyargalin	ஆரியரகளின்
aariyarkalin	ஆரியர்களின்
aarppaattangalai	ஆர்ப்பாட்டங்கள்
aarppaattanggalai	ஆர்ப்பாட்டங்கள்
aarppaattangkalai	ஆர்ப்பாட்டங்கள்
aarppaattangal	ஆர்ப்பாட்டங்கள்
aarppaattanggal	ஆர்ப்பாட்டங்கள்
aarppaattangkal	ஆர்ப்பாட்டங்கள்
aarppaattam	ஆர்ப்பாட்ட
aarvaththil	ஆர்வத்தில்
aarvaththai	ஆர்வத்தை
aarvaththaik	ஆர்வத்தைக்
aarvamum	ஆரவமமும்
aarae	ஆரை
aarkaadu	ஆர்காடு
aatkaadu	ஆட்டாகு
arcod	அரசுத்
aatralaal	ஆற்றலியல்
aatrtralaal	ஆற்றலால்
aatrtralil	ஆற்றலில்
aattralil	ஆற்றிலல்
aatrtralulla	ஆற்றுள்ளால்
aattralulla	ஆற்றுள்ளால்
aatrtru	ஆற்று
aattru	ஆய்று
aatrtrukku	ஆற்றுக்கு
aattrukku	ஆற்றுக்கு
aalayangalin	ஆயலங்களின்
aalayanggalin	ஆயலங்களின்
aalayangkalil	ஆயலங்களில்
aalayankalin	ஆலயங்களின்
aalayangalai	ஆயலங்களை
aalayanggalai	ஆயலங்களை
aalayangkalai	ஆயலங்களை
aalayankalai	ஆயலங்களை
aalayath	ஆயயது
aalayaththirku	ஆயலத்திற்கு
aalayatthirkku	ஆலயத்திற்கு
aalayaththukku	ஆலயத்துக்கு
aalayamum	ஆயமுும்
aalaiyam	ஆயையும்
aalaiyum	ஆயுசையும்
aaloachanaikalaiyum	ஆலோசகையியும்
aaloasanaigalaiyum	ஆலோசகலையியும்
aaloasanaikalaiyum	ஆலோசகலையியும்
aaloasanaikalayum	ஆலோசகலையும்
aalosanaigalaiyum	ஆலோசங்கையும்
aalosanaikalayum	ஆலோசங்கையும்
aaloachanaikal	ஆலோசனைகள்
aaloasanaigal	ஆலோசனைகள்
aaloasanaikal	ஆலோசனைகள்
aalosanaigal	ஆழசோனைகள்
aalosanaikal	ஆழசோனைகள்
ikkaruvi	இக்குரவி
ikkaruviyai	இக்குரவியை
ekkoottaththil	இக்கோட்டத்தில்
ikkoottaththil	இக்கோட்டத்தில்
engkaethaan	எங்கேதம்
ingaethaan	இங்காத்தன்
ingkaethaan	இங்காத்தன்
ichaikkaruvi	இசைக்கவரவி
isaikkaruvi	இசைக்கவரவி
ichaikkaruvikalai	இசைக்கவருக்கிய
isaikkaruvigalai	இசைக்குரவிலை
isaikkaruvikalai	இசைக்குரவிகளை
ichaikkaruviyai	இசைக்கருவையி
isaikkaruviyai	இசைக்கருவியை
inchchi	இஞ்சிச்
inchi	இன்சி
injchi	இஞ்சி
idaodhikkeedu	அடைத்திக்க்டு
idaodhukkeedu	அடுத்துக்கேடு
idaothukkeedu	இடுத்துக்க்க்ட
idaththila	இடத்தில்
idaththilum	இடத்திலும்
idiththu	இடித்து
vittu	விட்டு
idippu	எடிப்பு
idugaigalil	இடுகைகளில்
idaiyooraaga	இடையோராக
idaiyooraaka	இடையோராக
idaiyaeyaana	இடையாயன்
inaiyaanadhu	இணையானது
inaiyaanathu	இணையானது
inaiyaanavai	இணையானவை
idhanaal	இநதால்
ithanaal	இதனால்
idhanaalthaan	இதனால்தான்
ithanaalthaan	இதனால்தான்
idhara	இதரு
itara	இதரா
ithara	இதரு
othar	தன்
othara	நோதர்
other	அன்தி
othera	ஒத்திரா
idhazhaaga	இதசாக
ithalaaka	இதலாக
ithazhaaka	இதழாக
idhoa	இநோது
ithoa	இதோ
iththiraippadaththin	இத்திரைப்படுத்தின்
iththiraippadaththai	இத்திரைப்படுத்தை
iththeevil	இத்தெவில்
iththeevu	இத்தீவு
indana	இந்தான
indiana	இந்தியான்
inidiiana	இநிதியான்
inidiyana	இநிதியான
intiyana	இந்தியான
indiavirkul	இந்தியாவிற்கு
inthiyaavirkul	இந்தியாவிற்குள்
inththiyaavirkul	இந்தியாவிற்குள்
indiavil	இந்தியாவில்
inthiyaavil	இந்தியாவில்
inththiyaavil	இந்தியாவில்
indiavai	இந்தியாவை
inthiyaavai	இந்தியாவை
inththiyaavai	இந்தியாவை
indhuk	இந்துக்
indhukkalukku	இந்துக்களுக்கு
innigazhvukku	இந்நிகளுக்கு
inthnikalvukku	இந்நிகள்குக்கு
innigazhvai	இந்நிகழ்வை
inthnikalvai	இந்நிகள்வை
inniruvanangal	இந்நிருவங்களன்
inniruvananggal	இந்நிருவங்கள்
inthniruvanangkal	இந்நிருவங்களின்
inniruvanam	இந்நிருவம்
inthniruvanam	இந்நிருவனம்
innoayai	இந்நோயை
innooyai	இந்நோயை
inthnoayai	இந்நோயை
inaththavar	இநத்தவர்
enra	னியா்
entra	நேற்ற
inam	ணைம்
yenra	யின்ற
inavaatham	இனவதம்
inaviruththi	இணவித்துர்தி
inaiya	இனைய
incoa	இன்சு
ingaa	இங்கா
inkaa	இந்கா
innal	நிந்தல்
innel	இன்சில்
innalgal	இந்நாள்கள்
innalkal	இந்நுள்கள்
innelkal	இந்நிலக்கள்
innichai	இந்சியை
innisai	இந்னிசை
innichaik	இந்சியைக்
innisaik	இந்நீசைச்
innum	இனும்
indralavilum	இன்றளவிலும்
inralavilum	இன்றளவிலும்
intralavilum	இன்றளவிலும்
indralavum	இன்றவளும்
inralavum	இன்றவளும்
intralavum	இன்றவவும்
indri	இனிர்தி
inri	னிர்
intri	இனிற்றி
indrith	இன்றித்
inrith	இனித்து
intrith	இன்றித்
indriyum	இன்றியும்
inriyum	இனியிறும்
intriyum	இன்றியும்
ippadai	இப்படை
ippatai	இப்படை
ipparavai	இப்பவரை
ipparavaigal	இப்பவரைகள்
ipparavaikal	இப்பவரைகள்
ippalli	இப்பாலி
ippalliyil	இப்பளிளியில்
ippaadhai	இப்பாதை
ippaathai	இப்பாத்தி
ippaadhaiyil	இப்பாதையில்
ippaathaiyil	இப்பாதையில்
ipporutkal	இப்போருட்கள்
ippoathaiya	இப்போதைய
ibraahim	இப்ராசி
ibraakim	இப்ராகிம்
ibrahim	இப்ரிதம்
ipraakim	இப்ராகிம்
imayamalaiyin	இயமமாயியின்
himachala	சிமாழம்
imaachchala	இமாச்சல்
himachalap	சிமாசப்
imaachchalap	இமாச்சால்
immakkal	இம்மக்கள்
iyakkaththaich	இயக்கத்தைச்
iyakku	இயக்கு
eiyalpaiyum	இயல்பையும்
iyalbaiyum	இயல்பையும்
erattippaaka	இறத்பிடாக
irattippaaga	இறட்பிடாக
irukka	இருக்க
koodaathu	கூடாது
koodadhu	கூடது
koodum	கூடும்
kutatu	குடடு
irukkap	இருக்கப்
irukkavillai	இருக்கவில்லை
irukkavoa	இருக்கவோ
irukkumpoathu	இருக்கும்போது
iruchakkara	இருச்கரக்
irusakkara	இருசகரக்
iruppai	இருப்பை
iruppaiyum	இருப்பையும்
irumal	இருமல்
irumurai	இருமுறை
irumbuth	இரும்புத்
irumputh	இரும்புத்
irumbub	இரும்புப்
irumpup	இரும்புப்
irugi	இருக்
iruki	இருக்கி
irugik	இருக்கி
irukik	இருக்கி
ilakka	இலக்கு
ilakkam	இகக்கம்
ilakkin	இலக்கின்
ilakkil	இலக்கில்
ilatcha	இயல்தா
latcha	நாத்ச்
ilatchaththirkum	இலத்தார்சிக்கும்
ilatchiyaththirkum	இலை்சதிரியத்தும்
latchaththirkum	உட்சத்திருக்கும்
latchiyaththirgum	உட்சியத்திருக்கு
ilatchumi	இலத்சுமி
lakshmi	லா்சி
latchchumi	லட்சும்சி
illaiyena	இல்லையின்
illaiyenil	இல்லையின்ல்
ilamvayathilaeyae	இளவ்மயத்திலேயே
ilamvayathileayea	இலவ்மயத்தியேயே
ilamvayidhilaeyae	இளம்வியையிலேய
ilanthu	இநந்து
izhanththu	இழந்து
izhanthu	இநந்து
evatrtrukkum	இவற்றுக்கும்
ivatrtrukkum	இவற்றுக்கும்
ivatrukkum	இவற்றுக்கும்
evaa	வையா
ivaa	இவாவு
evai	வையோ
ivai	வையோ
evaikalaal	இவைகளால்
ivaikalaal	இவைகளால்
evaikalil	இவைகளில்
ivaigalil	இவைகளில்
evaikalukku	இவைகளுக்கு
ivaigalukku	இவைகளுக்கு
evaikalae	இவகளை
ivaigalae	இவைகளே
evaikalai	இவைகளை
ivaigalai	இவைகளை
evaikalaith	இவைகளைத்
ivaigalaith	இவைகளைத்
evaithaan	இவதியான்
ivaithaan	இவைதான்
evaiyellaam	இவையில்லாம்
ivaiyellaam	இவையில்லம்
ivvaiyellaam	இவைவிலேலும்
evaiyae	இவையே
ivaiyae	இவையே
ivvaiyae	இவைவே
eesanin	யினன்
eesan	யனசன்
eesal	யில்
eeya	ய்யாவு
iiya	யியா
iya	யியா
eerppu	எற்பு
ierppu	இறுப்பு
irppu	இறுப்பு
eerppup	எறுப்பு
eerppuvisai	எற்புவிசை
eeru	எனு
eerugalai	ஏறுகளை
eerukalai	ஏருகளை
eevu	ஏ்வு
evu	னவு
ugandha	உகந்த
ukandha	உகந்த
ungantha	உங்கந்த
ugandhavai	உகந்தவை
ukandhavai	உகந்தவை
ukanththavai	உகந்தவை
udalilum	உடலிலும்
udalil	உடலில்
udalai	உடாய்
vittu	விட்டு
udalaik	உடைசு
udalnalam	உடல்நாலம்
udaindhadhu	உடைந்தது
udainthathu	உடைந்தது
utkolluthal	அற்குட்துள்ள
utkollum	உட்டுகொள்ளம்
utkolvathu	உட்குவொத்து
udpuramaaka	உத்புரமாக
utpuramaaga	உற்புமாற
utpuramaaha	உத்புரமா
udpuram	உட்புரம்
utpuram	உற்றும்
unarvaaga	உணர்வாக
unarvaaka	உணர்வாக
vagaigalai	வகைகளை
vagaikalai	வகைகளை
vakaikalai	வகைகளை
unavugalil	உணவுகளில்
unavukalil	உணவுகளில்
unavugalum	உணவுகளும்
unavukalum	உணவுகளும்
unavugalaich	உணவுகளைச்
unavukalaich	உணவுகளைச்
uanvugalaiyum	உண்புகளையும்
unavugalaiyum	உணவுகளையும்
unavukalaiyum	உணவுகளையும்
unavukkaaga	உணவுக்காக
unavukkaana	உணவுக்கான
unavuch	உணவுச்
unavudan	உணவுுடன்
unavutan	உணவுடன்
unda	உண்டு
unnda	அண்டுந்த
unta	உண்டு
undaanadhu	உண்டானது
undaanathu	உண்டானது
untaanathu	உந்தானது
unththum	உந்தும்
unthum	உந்தும்
uppsala	உப்பாள்
uppsalaa	உப்பளா
upsala	உசப்பா
upsalaa	உப்பாள
upsalla	உப்பல்
uuppsala	உப்பாச்
uuppsalaa	உப்பாள
uupsalla	உப்பல்
uppu	உப்பு
uppugalum	உப்புகளும்
uppukalum	உப்புகளும்
uppum	உப்பும்
umathu	உமது
umai	உமை
ummaa	உம்மா
uyirinamaaga	உயிரியமாக
uyirinamaaka	உயிரியமாக
uyirinam	உயிரினம்
uyirmai	உயிரம்
uyirvaala	உயிர்வாள
uyirvaazha	உயிர்வாவ
uyirvaalum	உயிர்வாளும்
uyirvaazhum	உய்ரிவாசும்
uyilil	உயிலில்
uyil	யூவில்
uriththaana	உறித்தான
urga	ஊர்க்
uruga	உறுக்
uruka	உருக்
urukkiya	உருக்கிய
uruvappadaththai	உருவப்படத்தை
uruvappataththai	உருவப்படத்தை
uruvappadam	உருவப்படம்
uruvappatam	உருவப்படம்
uruvaagak	உருவாக்
uruvaakak	உருவாக்
uruvaagavillai	உருவாகவில்லை
uruvaakavillai	உருவாகவில்லை
uruvaagavum	உருவாகவும்
uruvaakavum	உருவாகவும்
uruvaagiyulla	உருவாகியுள்ள
uruvaakkaththin	உருவாக்கத்தின்
uruvaakaththirku	உருவாகத்திற்கு
uruvaakkaththirku	உருவாக்கிறத்து
uruvaakaththilum	உருவாகத்திலும்
uruvaakkaththilum	உருவாக்கத்திலும்
uruvaakkappadum	உருவாக்கப்படும்
uruvaakkamum	உருவாக்கமும்
uruvaakkal	உருவாக்கள்
uruvaakkaamal	உருவாக்காமல்
uruvaakkuvatharku	உருவாக்குவதற்கு
uruvaakkuvathu	உருவாக்குவது
uraiyaadalgalil	உரையாடல்களில்
uraiyaadalkalil	உரையாடல்களில்
uraiyaatalgalil	உரையாட்டளில்
uraiyaadalgalai	உரையாடல்களை
uraiyaadalkalai	உரையாடல்களை
uraiyaatalgalai	உரையாட்களை
urangaamal	உரங்காமல்
urangkaamal	உரங்காமல்
kondirundha	கொண்டிருந்த
kontirunta	கொண்டிருந்த
kontiruntha	கொண்டிருந்த
uravaaga	உரவாக
uravaaka	உரவாக
urudhiyaana	உறுதியான
uruthiyaana	உறுதியான
urudhiyaanathum	உறுதியானதும்
uruthiyaanathum	உறுதியானதும்
uruppu	உறுப்பு
uruppugalin	உறுப்புகளின்
uruppugalukku	உறுப்புகளுக்கு
uruppugalukkum	உறுப்புகளுக்கும்
uruppugalaiyum	உறுப்புகளையும்
uruppugal	உறுப்புகள்
uruppukku	உறுப்புக்கு
uruppukkum	உறுப்புக்கும்
uruppum	உறுப்பும்
ulaginai	உழகினை
ulakinai	உழகினை
ulagaip	உலகைப்
vaanoordhi	வானுத்தி
vaanoorthi	வானுத்தி
vaanuurthi	வானுத்தி
vaanuurti	வானுர்த்தி
vanurti	வனுருத்
varukindrana	வருகின்றன
varukinrana	வருகின்றன
uloom	உசும்
ulum	உமுள்
ulladakka	உள்ளடுக்
ullatakka	உள்ளடுக்
ulladakkamum	உள்ளடக்கமும்
ullatakkamum	உள்ளடக்கமும்
ulladakkum	உள்ளடக்கும்
ullatakkum	உள்ளடக்கும்
ullirunththu	உள்ளிருந்து
ullirunthu	உள்ளிருந்து
ulvaanggiya	உள்வாக்கிய
ulvaangkiya	உள்வாக்கிய
ulvaankiya	உள்வாக்கிய
ulaippukku	உளைப்புக்கு
ulaipputhaan	உழைப்புதான்
uzhaippukku	உழைப்புக்கு
oodaka	ஓடாக
udaka	உடகா
uudaaka	ஊடாக
uudaka	ஊடக்
oodagaththil	ஊடகத்தில்
oodakaththil	ஊடகத்தில்
udagaththil	உடகத்தில்
uudakaththil	ஊடகத்தில்
oodagaththai	ஊடகத்தை
oodakaththai	ஊடகத்தை
udagaththai	உடகத்தை
uudakaththai	ஊடகத்தை
oodagap	ஊடக்
oodakap	ஊடக்கப்
uudagap	ஊடக்
uudakap	ஊடக்கப்
oodagam	ஊடக்கம்
uoodagam	ஊடக்கம்
uudakam	ஊடக்கம்
oothaa	ஓத்து
uuthaa	உயது
ooraga	ஊரக்
uooraga	ஊராச்
uuraaka	ஊராக்
oorae	ஊரை
uurae	ஊரை
oorvalamaaga	ஓர்வமாகவு
oorvalamaaka	ஓர்வமாகவு
uurvalamaaka	உர்வளமாக
expo	ெய்சோப்
yekspoa	கோஸ்பா
enggo	என்கோ
engkoa	நாக்கோ
enkoa	நைக்கோ
esuppaaniya	யூச்பாணியா
yesuppaaniya	யூச்பாணியா
enchchi	எஞ்சி
enchi	னிஞ்சி
enjgi	எஞ்சி
enchin	என்சின்
engine	என்னிஷ்
edukkappadaamal	எடுக்கப்படாமல்
yedukkappadaamal	எடுக்கப்படாமல்
ettappadum	எட்டப்படும்
etttappadum	எட்டப்படும்
ettaavathu	எட்டாவது
ettiyathu	எட்டியது
yettiyathu	எட்டியது
ennikkai	என்னிக்கை
yennikkai	என்னிக்க
ennikkaiyaana	எண்ணிக்கையான
ennikkaiyilum	எண்ணிக்கையிலும்
ennikkaiyil	எண்ணிக்கையில்
ethargaaka	எதர்காக
etharkaaga	எதர்காக
etharkaaka	எதர்காக
ethiraali	எதிராலி
ethiraaliyin	எதிராலியின்
edhirkka	எதிர்க்க
ethirkka	எதிர்க்க
yedhirkka	எதிர்க்க
edhirkkavillai	எதிர்க்கவில்லை
ethirkkavillai	எதிர்கவக்்ில்
yedhirkkavillai	எதிர்க்கவில்லை
edhikkavum	எதிக்கவும்
ethirkkavum	எதிர்கவும்
yedhirkkavum	எதிர்க்கவும்
edhirkaamal	எதிர்காலம்
ethirkkaamal	எதிர்காலம்
yedhirkaamal	எதிர்காலம்
yedhirkkaamal	எதிர்காலம்
edhirpaarppu	எதிர்பார்ப்பு
ethirpaarppu	எதிர்பார்ப்பு
edhirpaarppugal	எதிர்ப்புற்கால்
ethirpaarppugal	எதிர்பிப்போர்கள்
ethirpaarppukal	எதிர்பிர்போக்கள்
edhuvaaga	எதுவாக
ethuvaaka	தழுவாக
yedhuvaaga	எதுவாக
einid	யின்த்
enid	னியுத்
eniid	னியித்
eynid	யின்து
iinid	யின்தி
inid	னிய்டு
iniid	ினிட்
iynid	யிந்தி
yenid	யின்டு
enin	னின்
amili	முிலி
amily	அமில்
emeli	மெலி
emely	மெய்லி
emile	மெலில்
emili	மிலில்
emilie	மெலிலி
emilii	மிலிலை
emily	மில்லி
imili	மிலில்
imilii	மில்லி
imily	மில்லி
yemili	மிலில்
eytha	யந்தா
yeitha	யந்தா
eythi	ெயத்தி
yeithi	யித்தி
eythum	எனுத்
yeithum	எனுத்
erinththu	எறிந்து
erinthu	எறிந்து
yerinthu	எறிந்து
erinththu	எறிந்து
erinthu	எறிந்து
yerinththu	எறிந்து
elaktraankal	இழற்கான்றால்
electronkal	எலெஸ்டின்கால்
yekaltraankal	இயற்கொள்ளான்
elimaiyaaka	எளிமையாக
yelimaiyaaga	எளிமையாக
yelimaiyaaka	எளிமையாக
elimaiyaakak	எளிமையாகக்
yelimaiyaagak	எளிமையாகக்
yelimaiyaakak	எளிமையாகக்
el	னை
yel	யில்
yell	ெய்தில்
ezhuthiyulla	எழுதியுள்ள
yeluthiyulla	எழுதியுள்ள
ezhuthiyullathu	எழுதியுள்ளது
yeluthiyullathu	எழுதியுள்ளது
ezhuthiyullanar	எழுதியுள்ளனர்
yeluthiyullanar	எழுதியுள்ளனர்
evarukkum	வேருக்கும்
yavarukkum	வயருக்கும்
evarumae	வருமே
yavarumae	வயருமே
eavar	யவவிர்
evar	யவவர்தி
ever	வியர்
ewer	யுவர்
ivir	வியிர்
yavar	யவர்
yevar	யுவர்
evvitha	இவிவித்
yavvitha	யாவிவத
evvithak	இவ்விதத்
yavvithak	யாவிவதுக்
evvithaththilum	இவ்விதத்திலும்
yavvithaththilum	யவவிந்தித்தும்
evvithamaana	இவ்விதமான
yavvithamaana	யவவிவிதமான
eavvitham	ஆவிவிதம்
evvitham	இவிவிதம்
yavvitham	யாவிவதும்
aegapoaka	ஆகோபோக்
aekapoaka	ஆகோபோ
eekapoaka	இகோபோ
ekapoaka	இகோபோ
aekapoagam	ஆகோபாகும்
aekapoakam	ஆகோகபம்
eekapoakam	இகோபாம்
ekapoakam	எகோபோகம்
aengchal	எங்கள்
angel	அங்கில்
aanai	ஆணை
aenai	யனனை
yaenai	யனனை
april	அபிரில்
aprill	அபிருள்
eepral	இப்புள்
epril	எப்பில்
aeriya	ரேயி
eeriya	ரியா
eriya	ரெய்
yeeriya	ரியா
aerkanavae	ஏற்கவணே
earkanavae	ஏற்கணேவே
eerkanavae	ஏறக்கவே
erkanavae	ஏற்கவேன
aerpadak	ஏற்படக்
yerpadak	ஏற்பாடக்
yerpadk	ஏற்படுக்
aerpadakkoodaathu	ஏற்படக்கோடுடு
yerpadakkoodiya	ஏற்படக்கூடிய
aerpadavillai	ஏற்படவில்லை
yerpadavillai	ஏற்படவில்லை
aerpadavum	ஏற்படவும்
yerpadavum	ஏற்படவும்
aerpadavae	ஏற்படவே
yerpadavae	ஏற்படவே
yerpadave	ஏற்படவே
aerpadaatha	ஏற்படாத
earpadaatha	ஏற்படாத
yerpadaatha	ஏற்படாத
aerpadaamal	ஏற்படாமல்
earpadaamal	ஏற்பாடமல்
erpadaamal	ஏற்பாடமல்
aerpaduthal	ஏற்படுத்தல்
earpaduthal	ஏற்படுத்தல்
yerpaduthal	ஏற்படுத்தல்
aerpadum	ஏற்படும்
yaerpadum	ஏற்படும்
yerpadum	ஏற்படும்
aerpaduvatharku	ஏற்படுவதற்கு
yaerpaduvatharku	ஏற்படுவதற்கு
yerpaduvatharku	ஏற்படுவதற்கு
aerpaduvathudan	ஏற்படுவதுடன்
yaerpaduvathudan	ஏற்படுவதுடன்
yerpaduvathudan	ஏற்படுவதுடன்
aetrtru	ஏற்று
eattru	இற்று
eetrtru	ஏற்று
etrtru	எறற்று
aetrtrukkondathu	ஏற்றுக்கொண்டது
eattrukkondathu	ஏற்றுக்கொண்டது
aetrtrukkondanar	ஏற்றுக்கொண்டனர்
eattrukkondanar	ஏற்றுக்கொண்டனர்
aetrtrukkondu	ஏற்றுக்கொண்டு
eattrukkondu	ஏற்றுக்கொண்டு
aetrtrup	ஏற்றுப்
aettrup	ஏற்றுப்
eetrtrup	ஏற்றுப்
etrtrup	எறற்றுப்
aelakiri	ஆழகிறி
ealagiri	ஆழகிறி
elakiri	இலகிரி
yaelagiri	ஏழகிறி
yaelakiri	ஏழகிறி
yelagiri	எழகிறி
ainaa	யநாதி
ayna	யந்தா
aynaa	யநாதா
ina	யந்தா
inaa	இனா
odeesee	ரூசையே
odeesey	ரோய்சிய
odeessei	டோச்சிய
odeessey	தோர்சேய்
odici	ஓடிய்க்
odiisii	ஓடிசி
odiissey	டோரிஸ்யா
odisee	ஆடிசியோ
odisi	ஓடிசி
odisii	ஓடிசி
odissei	ஒட்சிசிய
odissi	டோிிஸ்
odssi	டச்சி
odysey	டோரிய்
odysi	டோசியி
odyssey	டோன்சியே
odyssi	டான்சி
ottaga	ஓட்டுக
ottaka	ஓட்டுக
ottagangal	ஓட்டங்களால்
ottaganggal	ஓட்டங்களகள்
ottakangkal	ஓட்டங்களகள்
chivingi	சிவிங்
chivingki	சிவிங்கி
civinki	விசிங்க்
sivingki	சிவிங்கி
ottagam	ஆட்டக்கம்
oththadhae	ஆத்ததே
oththathae	ஆத்ததே
oththulaikka	ஒத்துளைக்க
oththuzhaikka	ஒத்துழைக்க
oththulaiyaamai	ஒத்துலையமை
oththuzhaiyaamai	ஒத்துழையை
ondrae	ஒன்றே
onrae	னற்றே
oppandha	ஒப்பந்த
oppantha	ஒப்பந்த
oppandhak	ஒப்பந்தக்
oppanthak	ஒப்பந்தக்
oppandhathirgu	ஒப்பந்தத்திற்கு
oppandhaththirku	ஒப்பந்தத்திற்கு
oppanthaththirku	ஒப்பந்தத்திற்கு
oppandhathil	ஒப்பந்தத்தில்
oppandhaththil	ஒப்பந்தத்தில்
oppanthaththil	ஒப்பந்தத்தில்
oppandhap	ஒப்பந்தப்
oppanthap	ஒப்பந்தப்
oppandham	ஒப்பந்தம்
oppantham	ஒப்பந்தம்
omar	ஓம்
omer	லும்
orumai	ஒருமை
orumayi	ரூமைய்
otrai	ஒர்றை
ottrai	ஆற்றை
oadhi	ஓத்தி
oathi	ஓத்தி
oodhi	ஓன்தி
oothi	னத்தி
cakti	ச்கிட்டி
chakthi	ச்கத்தி
sakthi	ச்கத்தி
horangal	ஹாரங்கள்
oorangal	ஊரங்கள்
orangal	ஊரங்கள்
vorangal	வரங்கள்
ooraandil	ஊராண்டில்
oraandil	ரோண்டில்
oovar	ஓவ்
ovar	ஓவ்
over	ஓவிய்
ower	னுவர்
overgal	வரிக்கல்
overkal	வரிக்கல்
kasappu	கசப்பு
kadandhadhu	கடந்தது
kadandhathu	கடந்தது
kadanthadhu	கடந்தது
kadanthathu	கடந்தது
kadamboor	கடம்பூர்
kadambur	கடம்புப்
kadarkarai	கடர்கரை
katarkarai	கடர்கரை
kadarkaik	கடக்கிற்
kadarkaraik	கடர்ககிற்
kadarkaraikku	கடர்ககிறுக்
kadarkaraiyin	கடர்கரியின்
kadarkaraiyilirundha	கடர்க்கையிரிருந்த
kadarkaraiyilirundhu	கடர்க்கையிலிருந்து
kadarkaraiyilirunthu	கடர்க்கையிலிருந்து
kadarkaraiyil	கடர்கரையில்
kadarkarayil	கடர்கரியில்
kadarkaraiyai	கடர்கரையை
kadalul	கடலுத்
kadavulae	கடவுள்ள
kadavule	கடவுள்
kadavulgalin	கடவுக்களின்
kadavulkalin	கடவுக்களின்
kadidhangalum	கடிதங்களும்
kadithangalum	கடித்தங்களும்
kadithangkalum	கடித்தங்களும்
kadidhangalai	கடித்தங்களை
kadithangalai	கடித்தங்களை
kadithangkalai	கடித்தங்களை
kadidhathil	கடித்ததில்
kadithaththil	கடித்தத்தில்
kadithatthil	கடித்தத்தில்
kadidhatai	கடித்தை
kadidhaththai	கடித்தத்தை
kadithaththai	கடித்தத்தை
kadidhamum	கடிதமும்
kadithamum	கடிதமும்
kadumaiyaanadhu	கடுமையானது
kadaichi	கடைச்சி
kadaisi	டாசிசி
kataisi	தாய்சி
kadaisiyaaga	கடைசியாக
kadaisiyaaka	கடைசியாக
kadaisiyaga	கடைசியாக
katch	யக்த்
kootch	யூட்சி
kutch	யுட்சி
kuutch	யூட்சி
qootch	கூட்ச்
qutch	யுட்சி
kattamaikka	கட்டமியுக்
kattamaikkappadum	கட்டமைக்கப்படும்
kattamaikkappatta	கட்டமைக்கப்பட்ட
kattaayamaagum	கட்டாயமாகும்
kattumaana	கட்டுமான
kattumaanangal	கட்டுமானங்கள்
kattumaananggal	கட்டுமானங்கள்
kattumaanap	கட்டுமானப்
kattumaanam	கட்டுமானம்
gana	கணா
kana	நாய்
kanak	னாக்
ganangal	கணங்கள்
kanangal	கணங்கள்
kanangkal	கணங்கள்
kanaththil	கனத்தில்
kanaththai	கனத்தை
kanamum	கணமும்
kanavaanathu	கனவானது
kanavanadhu	கனவனது
kanavanathu	கனவனது
kanetham	கனிதம்
kanidham	கணிதம்
kanitham	கணிதம்
kanu	னுக்
kandarindha	கண்டிரிந்த
kandarindhdha	கண்டிருந்த
kandarintha	கண்டிருந்த
kandarinththa	கண்டிருந்த
kandarindhadhu	கண்டரிந்தது
kandarindhdhadhu	கண்டிரந்தது
kandarinthathu	கண்டரிந்தது
kandarinththathu	கண்டிரந்தது
kandarindhanar	கண்டரிந்தனர்
kandarindhdhanar	கண்டிருந்தனர்
kandarinthanar	கண்டிருந்தனர்
kandarinththanar	கண்டிருந்தனர்
kandedukkappattadhu	கண்டிடுக்கப்பட்டது
kandedukkappattathu	கண்டிடுக்கப்பட்டது
kannaottaththil	கண்ணுட்ததத்தில்
kannoottaththil	கண்னுட்தத்தில்
kannoottatthil	கண்னுட்டத்தில்
kannottaththil	கண்னுட்டத்தில்
kadhirveechchin	கதிரிஸ்விக்ன்
kathirveecchin	கதிர்செய்விங்
kathirveechchin	கதிரிஸ்விக்கின்
canara	நாயர்
kanara	நார்
kannaiyar	கணணைய்்
kanniyar	கணியினர்
kabila	கோபிலா
vairamuththu	வைரமுத்து
vairamuthu	வைரமுத்து
vairamuttu	வைரமுட்து
committeeyin	காம்மீத்தியன்
committiyin	காமிமிட்டின்
kamittiyin	மகிட்டியின்
committeeyil	காம்மீத்தியில்
committiyil	காமிமிட்டியில்
kamittiyel	கமிட்டியில்
kamittiyil	கமிட்டியில்
kamba	கம்ப்
kampa	கம்ப்
kambangal	கம்பங்கள்
kambankal	கம்பங்கள்
kampankal	மக்பணங்கள்
cumbaththin	சும்பத்தின்
kambaththin	கம்பத்தின்
kambattin	கம்பட்டின்
kampatthin	மக்பத்தின்
kampattin	கம்பட்டின்
kamban	கம்பன்
kampan	கம்பன்
kambaramayanaththil	கம்பமரியந்தத்
kambaramayanattil	கம்பகமனியத்தின்
kamparamayanattil	கம்பகமனியத்தின்
kambarin	கமரபின்
kamparin	கம்பரின்
kambalaththu	கம்பளத்து
kambalattu	கம்பலாத்து
kambazhaththu	கம்பழத்து
kampalattu	கம்பாளத்து
companigal	கோம்பிங்கள்
companygal	கோம்பங்கள்
companykal	கோம்பநிகள்
kampenikal	மக்னிங்கை
companyin	காம்பனின்
kambeniyin	கம்பினியின்
kampeniyin	மக்பினியின்
kayitrtrunaal	கயிற்றுளான்
kayittrinaal	கயிற்றினால்
kayitrin	கியரின்
kayitrtrin	கயிர்றின்
kayittrin	கியர்தின்
kayitrril	கயிற்றில்
kayittril	கயிற்றில்
karan	கரன்
karavetti	கரவேத்தி
karache	கரச்சி
karachi	கரசி
karachii	கரசிசி
karachy	கரசி
karrachi	கராசி
qarache	கரச்சி
qarachi	கரச்சி
qarachii	கரசசி
qarachy	கரசி
qarrachi	கராச்சி
kariyamila	கரியமில்
karunaakara	கருணாக
karunakara	கருணகர்
karunaakaran	கருகானதர்
karunakaran	கருகனார்
karuththa	கருத்த
karuththaakkam	கருத்தாக்கம்
karuththuk	கருத்துக்
karuthuk	கருத்து
karuththukalin	கருத்துகளின்
karuththukkalin	கருத்துக்களின்
karuththukkal	கருத்துக்கள்
karuthukkal	கருத்துக்கள்
karumpalagaiyil	கரும்பாலையில்
karumpalahaiyil	கரும்பலையில்
karumpalakaiyil	கரும்பாலையில்
karumpulligal	கரும்புள்ளிகள்
karumpullikal	கரும்புள்ளிகள்
karnanin	கர்ணானின்
karnannin	கர்ணான்தின்
karna	ருந்தா
karnaa	கர்ணா
karnnaa	கர்ணாண்
karmangal	கர்மாங்கள்
karmanggal	கர்மங்கள்
karmangkal	கர்மங்கள்
karmam	கரமம்
karpadhil	கற்பதில்
karpathil	கற்பதில்
karpatthil	கற்பத்தில்
karpikka	கர்பிக்க
karpikkappattu	கர்கிக்கப்பட்டு
vitum	விடும்
kalandhukolkiraargal	கலந்துக்கொள்ளார்கள்
kalandhukolkiraarkal	கலந்துக்கொள்ளார்கள்
kalanthukolkiraargal	கலந்துகொள்ளிகளார்
kalanthukolkiraarkal	கலந்துகொள்ளிகளார்
kalaai	காலை
kalaay	காய்
kalai	காலை
kalingap	களிங்கப்
galileo	களிலியோ
kalyaana	கழியான
kalyana	களியான
kalyaanap	கலியானப்
kalyanap	களியான்
kalyaanam	காலியம்
kalyanam	கானியம்
kallaala	கல்லா
kallala	கல்லா
kallum	குள்ளும்
kalloori	கலூரி
kalluri	களுரி
kaloori	கரூரி
kalloorigalilum	கலோலிருகிலும்
kalloorikalilum	கலோலிரிகளும்
kallurigalilum	கல்லுரிகளிலும்
kallurigazhilum	கல்லுரிகளிலும்
kallurikalilum	கல்லுரிகளிலும்
kallurikazhilum	கல்லுரிகளிலும்
kalloorigalum	கலோருலிக்கு
kalloorikalum	கலோரிலுக்கும்
kallurigalum	கல்லுரிகளும்
kallurigazhum	கல்லுரிக்கும்
kallurikalum	கல்லுரிக்கும்
kallurikazhum	கல்லுரிக்கும்
kallooriyaaga	கலோலிராயா
kallooriyaga	கலோலியார
kalluriyaga	கல்லிரிய
kalluriyaka	கல்லிரிய
kallooriyilum	கலோலோரியிடு
kalluriyilum	கல்லுரியிலும்
muraiyil	முறையில்
kalvikkaaga	கல்விக்காக
kalvikkaga	கல்விக்காக
kalvikkaka	கல்விக்காக
kalvikkaana	கல்விக்கான
kalvikkana	கள்விக்கான
kalvippani	கலிவ்ப்பணி
kalviyaandu	கல்வியாந்து
kalviyilum	கல்வியிலும்
kalviyum	கள்வியும்
kalviyae	கழ்வியை
kalviye	கழ்வியை
kalviyoadu	கல்வியோடு
kalviyodu	கள்வியோது
kalalai	களை
kazhalai	களை
kalutai	குதாத்
kaluthai	கழுதை
kazhudhai	கழுதை
kavalai	கவவை
kavali	கவவில்
kavalaippadum	கவலைப்படும்
kavalaippatum	கவலைப்படும்
kavalaiyae	கவையையே
kavalaiye	கவலையே
kavalaiyee	கவையேலி
kavalaiyai	கவலையை
cofee	கோே
coffee	பஞ்சு
kaahpi	குப்பி
kaattup	காட்டுப்
kaattuyir	காட்டுயிர்
kaattuvadhaaga	காட்டுவதாக
kaattuvadhaga	காட்டுவதாக
kaattuvathaaga	காட்டுவதாக
kaangiradhu	காங்கிறது
kaangirathu	காங்கிறது
kaankirathu	காங்கிறது
kaangiraan	கார்கினான்
kaankiraan	கார்கினான்
kaangiraar	கார்கிறார்
kaankiraar	கார்கிறார்
kaanbiththadhu	காண்பித்தது
kaanbiththathu	கான்பித்தது
kaanpiththathu	கான்பித்தது
kaanbiththaar	கான்பித்தார்
kaanbithththaar	கான்பித்தார்
kaanpiththaar	கான்பித்தார்
kaathalukku	காதுகளுக்
kathalukku	கதலுக்கு
kaathin	கிதின்
kathin	கினத்தின்
kaathil	காத்தில்
kathil	கத்தில்
kaathirundha	காதிருந்த
kaathiruntha	காதிருந்த
kaaththiruntha	காத்திருந்த
kaatthiruntha	காத்திருந்த
kaapoolil	கோப்பில்
kabulil	குபலில்
kaapaatrik	காபாப்றிக்
kaappaatrik	காப்பாற்றிக்
kaappaatrtrik	காப்பாற்றிற்
kaappeedu	காப்பீடு
kappeedu	கப்பீடு
kaappuk	காப்புக்
kappuk	கப்பு
kaaranangalukkaaga	காரணங்களுக்காக
kaaranangalukkaaka	காரணங்களுக்காக
karananggalukkaaka	கரணங்களுக்காக
kaaranaththaith	காரணத்தைத்
kaaranattait	காரணட்டைத்
kaaranatthait	காரணத்தைத்
karanaththaith	கரணத்தைத்
kaaranamaakac	காரணமாகச்
kaaranamaakach	காரணாமசச்
karanamaakach	கரணாமசச்
kaaranamaagattan	காரணமாகத்தன்
kaaranamaakaththaan	காரணமாகத்தான்
kaaranamaakattan	காரணமாகத்தன்
karanamaakaththaan	கரணாமத்தானத்
kaaranamaagap	காரணமாகப்
kaaranamaakap	காரணமாகப்
karanamaakap	கரணமாகப்
kaaranamaagavum	காரணமாகவும்
kaaranamaakavum	காரணமாகவும்
karanamaakavum	காரணாாகவும்
kaaranamaagave	காரணமாகவே
kaaranamaakave	காரணமாகவே
karanamaakave	கரணாமாவி
kaaranamaagum	காரணமாகும்
kaaranamaakum	காரணமாகும்
karanamaakum	காரணமாகும்
kaari	ரிய்
cargalin	கர்களின்
cargazhin	கர்ஜிின்
kargalin	கர்களின்
karkalin	கர்களின்
cargal	கர்கள்
kaargal	கர்
kaarkal	கர்க்கள்
cork	ரூக்
corka	கர்
corq	ருக்
corqa	கர்
garg	கர்
kaarg	யர்
kaark	யர்க்
kark	யர்க்
kork	னுர்க்
qorq	னுர்க்
carson	சரசன்
kaarsan	கரரசன்
karson	கரசன்
gardan	கர்தான்
garden	கரரண்டி
kaardan	கரரண்ட
kaartan	கர்டு
kardan	கர்டன்
kaarthikeyan	கார்தியியன்
kaartikeeyan	கார்டியாயின்
karthikeeyan	கர்த்தியாயின்
karthikeyan	கர்த்தியான்
cornar	கரரண்்
corner	கரரண்்
kaarnar	கரரண்்
carlo	யூர்லா
carloo	கரோலோ
karloo	கற்சோ
caarloos	கார்லூ
caarlos	சார்லு
carloos	கரலூர்
carlos	கரலஸ்
karloos	கலரூர்
karlos	கரலூர்
qarlos	கரலூர்
kaatrin	கிற்றின்
katrin	கிற்றின்
kaattrae	கற்றி
kaattre	யாற்றி
katre	றிதே
kaalakattangalil	காலகட்டங்களில்
kalakattangalil	கலகட்டங்களில்
kalakattanggalil	கலகட்டங்களில்
kalakattankalil	கலகட்டங்களில்
kaalakattaththilum	காலகத்தடுத்தில்
kalakattaththilum	கலகத்தாட்டுள்ளும்
kaalakattaththil	காலகட்டத்தில்
kalakattaththil	கலகத்தாட்தில்
colonygalai	கோழினாகளை
kaalanigalai	காலணிகளை
kaalanikalai	காலனிகளை
colonygal	கோழினாக்
kaalanigal	காலிிகள்
kaalanikal	காலிிகள்
kaalaththai	காதத்தை
kaalattai	காலட்டை
kaalatthai	காதத்தை
kaalaththaich	காலத்தைச்
kaalattaic	காலட்டைச்
kaalatthaic	காலத்தை
kaalamae	காலமே
kaalame	காலம்
kaalamee	காலேம்
kaalaandil	காலாந்தில்
kaalaantil	காலாந்தில்
kaalin	கிழின்
kaaliya	காலிய
kaaliyaa	காலிய
kaavalthuraik	காவல்துக்கை
kaavalturaik	காவல்டுறைக்
kaavalthuraip	காவர்துத்ப்
kavalthuraip	கவர்த்துவை
kavalturaip	கவர்துவைப்
kaavalthuraiyaal	வாச்லுவரையில்
kaavalturaiyaal	காவல்துரையால்
kidakkiradhu	கிடக்கிறது
kidakkirathu	கிடக்கிறது
kitakkirathu	கிடக்கிறது
kitakkiratu	கிடக்கிறது
kidangku	கிடங்கு
kidangu	கிடங்கு
kidanku	கிடங்கு
kitanku	கிடங்கு
kidandha	கிடந்த
kidanta	கிட்டன்
kidantha	கிடந்த
kitanta	கிட்டான்
kitantha	கிடந்த
kidandhanar	கிடந்தனர்
kidanthanar	கிடந்தனர்
kitantanar	கிடந்தன்்
vaendiya	விண்டைய
vaendum	விண்டும்
vendia	விண்டை
vendum	விணுத்
ventiya	விந்தை
ventum	வினும்
kidaikkak	கிடைக்கு
kidaikkakk	கிடைக்க்கக்
kidaikkakkoodiya	கிடைக்கூட்டிய
kidaikkakkudiya	கிடைக்கக்குடிய
kidaikkakudiya	கிடைக்குடியத
kidaikkavillai	கிடைக்கவில்லை
kadaikkaadhadhaal	கடைக்கதாதால்
kidaikkaadhadhaal	கிடைக்காததால்
kidaikkaathathaal	கிடைக்காததால்
kidaikkadhadhaal	கிடைக்கதாதத்
kidaikkaadhu	கிடைக்காது
kidaikkaathu	கிடைக்காது
kidaikkaatu	கிடைக்காடு
kitaikkaathu	கிடைக்காது
kitaikkaatu	கிடைக்காடு
kidaikkindra	கிடைக்கின்ற
kidaikkinra	கிடைக்கின்ற
kitaikkinra	கிடைக்கின்ற
ginniyaa	கினியா
guinea	கியோவி
kinniya	கினியா
kinniyaa	கினியா
cuba	ூக்
cubaa	சுபா
cuuba	ூக்
cuubaa	சுபா
kiuba	கோரியா
kiubaa	கியோப்
kiuuba	கூரைப்
kiuubaa	கோயாப்
kyuba	யூசிபா
kyubaa	குயாப்
kyuuba	கூயோப்
kyuubaa	கூயாப்
qiuba	கோரியா
qiubaa	கியோப்
qyuba	யூசிபா
qyubaa	குயாப்
cubavil	குபவில்
kiyoobaavil	கியோபாவில்
kiyoopaavil	கியோபாவில்
kearan	யிரன்
keeran	ிறுு
kiiran	ிறியன்
kiran	ிறியன்
kirann	ிறான்
kyran	ிறயு
qeeran	ிறுசன்
qiiran	ிறியன்
qiran	ிறியன்
qirann	ிிராண்டின்
qyran	ிறியன்
graand	கிராண்டு
graind	கிரைந்து
grand	கிரண்டு
grend	ிருட்
kirand	கிரண்டு
kirubai	யுறைப்
kirubhai	கிறுப்
kirupai	யுறைப்
kirishthavarkalin	கிறித்தவர்களின்
kiriththavargalin	கிறித்தவர்களின்
kiritthavarkalin	கிறித்தவர்களின்
kiriththavargalum	கிறித்தவர்களும்
kiriththavarkalum	கிறித்தவர்களும்
kiritthavarkalum	கிறித்தவர்களும்
kirirththavargal	கிறித்துவராகள்
kiriththavargal	கிறித்தவர்கள்
kiriththavarkal	கிறித்தவர்கள்
kilovukku	கிழோவுக்கு
clive	கிழ்வே
cliwe	கிழியோ
kilaiv	கிழைவு
kilive	கிழிவே
kilar	யிர்ளா்
kizhaar	கிழார்
kizhar	யிர்ளாத்
geets	சியோத்
keat	ஞ்சு
keats	சியோத்
keet	ியு
keets	சிட்டு
kets	சிட்டு
kiids	ஸிட்டு
kiits	தியிஸ்
kits	திக்ஸ்
kyts	ஸ்டியு
qeat	ியு
qeats	சியோத்
qiits	தியிஸ்
qyts	ஸ்டியில்
geethanjali	கேதன்சனில்
keethanjali	கீழந்தனில்
geet	ியு
geeta	கியோட்டு
geethai	க்தை
giit	ியித்
giitaa	கியாத
git	ியித்
gita	கிட்டு
geethaiyil	கீழையில்
geethayil	கீழதைத்
keelirangi	கீழினார்
keelirangki	கீழினங்கி
keeliranki	கீழினார்கி
keezhiranggi	கீழிக்கின்
keezhirangi	கீழிரங்கி
keezhiranki	கீழிரங்கி
kudandhai	குடந்தை
kudanthai	குடந்தை
kudippalakkam	குடிப்பளக்கம்
kudippazhakkam	குடிப்பளககும்
kudai	குடை
kuday	டுகாய்
kutay	உடு
kudaindhdhu	குடைந்து
kudaindhu	குடைந்து
kudainthu	குடைந்து
kudayndhu	குடைந்து
kutaynthu	குடைந்து
kudaiyin	குடையின்
kudayyin	குடையின்
kutayyin	குடையின்
kudaiyil	குடையில்
kudayyil	குடையில்
kutayyil	குடையில்
good	கோருத்
goodd	குட்
goud	குருத்
gouud	குருத்
gud	ுகியோத்
gudd	ுடி
guud	ுக்கு
kud	ுகித்
gunamaa	குணமா
kunamaa	குணமா
kuyili	யுயில்
kurudhik	குறுத்திக்
kuruthik	குறுத்திக்
kuruvi	வுருத்தி
guruviyin	குருவியின்
kuriviyin	குறிவியின்
kuruviyin	குருவியின்
kurdhu	குருத்து
kurdu	குருத்து
kurthu	குர்து
kurichchi	குறிச்சி
kurichi	குரிச்சி
guru	ூருத்
kuru	ஊயுர்
kurukkup	குருக்குப்
kurukkum	குருக்கும்
kuruvai	குருவை
kuraindhavargal	குறைந்தவர்கள்
kuraindhdhavargal	குறைந்தவர்கள்
kurainthavarkal	குறைந்தவர்கள்
kuraindavai	குறைந்தவை
kuraindhdhavai	குறைந்தவை
kurainthavai	குறைந்தவை
kuraindhaal	குறைந்தால்
kuraindhdhaal	குறைந்தால்
kurainthaal	குறைந்தால்
kuraindhae	குறைந்தே
kuraindhe	குறைந்தே
kuraindhey	குரைந்தே
kurainthae	குறைந்தே
kulanggalin	குழங்களின்
kulangkalin	குழங்களின்
kulanggalum	குழங்களும்
kulangkalum	குழங்களும்
kulanggalai	குழங்களை
kulangkalai	குழங்களை
kulanggalaiyum	குழங்களையும்
kulangkalaiyum	குழங்களையும்
kulanggal	குழங்கள்
kulangkal	குழங்கள்
kulaththirku	குழத்திற்கு
kulatthirku	குழத்திற்கு
kulaththu	குழத்து
kulatthu	குழத்து
kulaththukku	குழத்துக்கு
kulatthukku	குழத்துக்கு
kulaththai	குழத்தை
kulaththi	குழத்தி
kulatthai	குழத்தை
kulamum	குழமும்
veentum	வின்தும்
vendum	விணுத்
ventum	வினும்
kuliththa	குழித்த
kuliththalai	குழித்தலை
kuliththal	குழித்தல்
kuliththu	குழித்து
kulithu	குழித்து
kulirchchi	குழிற்சிச்
kulumai	குழுமை
kulandhaai	குழந்தை
kulanthaai	குழந்தை
kulanthai	குழந்தை
kuzhandhaai	குழந்தை
kuzhandhaay	குழந்தை
kuzhanthaai	குழந்தை
kuzhanthai	குழந்தை
kulukkal	குழுக்கள்
kuzhukkal	குழுக்கள்
kuva	ூக்வு
kuvaa	குவா
kuwaa	குவா
kuantam	குண்டம்
kuantum	குண்டும்
kuantumm	குண்டும்
kuvandam	குவண்டம்
kvantam	குவந்ம்
kwantam	குவந்தம்
quantam	குண்டம்
quantum	குண்டும்
quantumm	குண்டும்
quuantam	கூண்டம்
quuantuum	கூன்டும்
quuantuumm	கூன்டுமும்
qwantam	குவந்தம்
kuvindhadhu	குவிந்தது
kuvindhathu	குவிந்தது
kuvintatu	குவிந்தாடு
kuvinthathu	குவிந்தது
kuvindhu	குவிந்து
kuvinthu	குவிந்து
kuvintu	குவின்து
ggo	ொக்
ggoo	கோர்
goo	னோர்
gu	னு
guu	ஜுவை
kuu	ூரை
koodaadhu	கூடாது
koodaathu	கூடாது
koodadhu	கூடது
koodathu	கூடது
koodich	கூடிச்
koodugalil	கூடுகளில்
koodukalil	கூடுகளில்
kuudukalil	கூடுகளில்
kuutukalil	கூடுகளில்
koodumaana	கூடுமான
kuudumaana	கூடுமான
kuutumaana	கூடுமான
koodum	கூடும்
kuudum	கூடும்
kuutum	கூடும்
koottangalin	கூட்டங்களின்
kuuttangalin	கூட்டங்களின்
kuuttankalin	கூட்டங்களின்
koottangalukku	கூட்டங்களுக்கு
kuttangalukku	குட்டங்களுக்கு
kuuttangalukku	கூட்டங்களுக்கு
kuuttankalukku	கூட்டங்களுக்கு
koottangalai	கூட்டங்களை
kuuttangalai	கூட்டங்களை
kuuttankalai	கூட்டங்களை
koottangalaiyum	கூட்டங்களையும்
kuuttangalaiyum	கூட்டங்களையும்
kuuttankalaiyum	கூட்டங்களையும்
koottangal	கூட்டங்கள்
kuuttangal	கூட்டங்கள்
kuuttankal	கூட்டங்கள்
koottath	கூட்டத்
kuuttat	சுட்டது
kuuttath	கூட்டத்
koottaththin	கூட்டத்தின்
kuutattin	கூடத்தின்
kuuttattin	குட்டத்தின்
koottaththai	கூட்டத்தை
koottatthai	கோட்டத்தை
koottaththaith	கூட்டத்தததத்
koottatthaith	கூட்டத்தைத்
kuuttattait	கூட்டத்தைய்
kuuttattaith	கூட்டத்தைத்
koottappatta	கூட்டப்பட்ட
kuutapata	கூட்டப்பட
kuuttappatta	கூட்டப்பட்ட
koottamum	கூட்டமும்
kuutamum	கூடமும்
kuuttamum	கூட்டமும்
koottam	கூட்டம்
kuutam	கூடம்
kuuttam	கூட்டம்
koottavum	கூட்டவும்
kuutavum	கூடவும்
kuuttavum	கூட்டவும்
koottaaka	கூட்டாக
koottaga	கூட்டாக
kuuttaaga	கூட்டாக
kuuttaaka	கூட்டாக
koottudhal	கூட்டுத்தல்
koottuthal	கூட்டுத்தல்
kootudhal	கூடுத்தல்
kooththu	கூத்து
kootthu	கூத்து
kuuthu	ூயுது
kuuttu	சுட்து
kooraiyil	கூரையில்
koorappatta	கூறப்பட்ட
kuurapatta	கூறப்பட்ட
kuurappatta	கூறப்பட்ட
koorappattirukkum	கூறப்பட்டிருக்கும்
kuurappatirukkum	கூறப்பாரித்துக்கும்
kuurappattirukkum	கூறப்பட்டிருக்கும்
koorappattu	கூறப்பட்டு
kuurapattu	கூரப்பட்டு
kuurappattu	கூறப்பட்டு
kooravum	கூரவும்
kuuravum	கூரவும்
kooraamal	கூராமல்
kuuraamal	கூராமல்
koorai	கூரை
cool	ருச்
cul	ுக்்
kool	ருச்
kul	ுகள்
kuul	ுகள்
qool	ருச்
qul	ுகள்
kedukkum	கேடுக்கும்
kedum	கிடும்
calvin	குழ்வின்
calwin	குவில்
kaelvin	கிழ்வின்
kalvin	குழ்வின்
kalwin	குழ்வின்
kelviin	கிழ்வைன்
kelvin	கிழ்வைன்
kelvinn	கிழ்வின்
kelwiin	கிழ்வைன்
kelwin	கிழ்வுண்
kelwinn	கிழ்வுண்
qalvin	குழ்வின்
qelviin	கிழ்வைன்
qelvin	கிழ்வின்
qelvinn	கிழ்வின்
kaettadhu	கேட்டது
kaettathu	கேட்டது
keattathu	கிட்டது
ketadhu	கேத்து
ketathu	கேத்து
kettadhu	கேட்டது
kettathu	கேட்டது
kaettadhum	கேட்டதும்
kaettathum	கேட்டதும்
ketadhum	கேததும்
ketathum	கேததும்
kaetanar	காத்தன்
kaettanar	காட்டினர்
kaettapoadhu	கேட்டபோது
kaettapodhu	கேட்டபோது
kaettapothu	கேட்டபோது
keattapoothu	கேட்டபோது
ketapodhu	கட்டோபது
ketapothu	கெதபோது
kaettaa	கிட்டா
ketta	கிட்ட
kaettaar	கேட்டார்
kettar	கிட்டர்
kaettaal	காட்டுள்
keettaal	கிட்டால்
ketal	கிடல்
kettal	கிட்டுள்
kaettullaar	கேட்டுள்ளார்
kettullar	கேட்டுள்ளாள்
kaendhiriya	கேந்திரிய
keanthiriya	காந்திரிய
kendhiriya	கெந்திரிய
kendriya	கென்றிய
keenl	ினுள்
keenneel	கினேல்
kenel	னியல்
kennel	கனனல்
qennel	கனனல்
cameeo	கேசு
cameo	சுமே
cameoo	கமூய்
ccameeo	கசூய்
ccameo	சுட்யோ
ccameoo	கசூத்
kaimioo	காயமூதி
kaimiu	கியமும்
kameeo	க்கேூ
kameo	க்கவே
kameoo	கமூய்
kamio	மூகி
kamioo	கமூரி
keemiyoo	கிக்யூதோ
kemioo	கிமூயோ
qaimioo	காமியோ
qameo	க்கூமீ
qamio	ரைமுசி
galeen	கிலேன்
galen	கிலன்
gallon	குளன்
galon	குஷன்
keelan	ிியல்
kaelu	ெயுது
kelu	ெயுது
kael	ைசுல்
kel	ைசுல்
kezh	லைசில்
kaidhigalin	கியிலகின்
kaidhikalin	கிதிகளின்
kaithigalin	கைதிகளின்
kaithikalin	கைதிகளின்
kaydhikalin	கிியிலின்
kaythikalin	காதியிகளின்
kadhigalukku	கதிகளுக்கு
kaidhigalukku	கைதிகளுக்கு
kaidhikalukku	கைதிகளுக்கு
kaithigalukku	கைதிகளுக்கு
kaithikalukku	கைதிகளுக்கு
kaidhigalai	கைதிகளை
kaidhikalai	கைதிகளை
kaithigalai	கைதிகளை
kaidhigal	கியில்கள்
kaidhikal	கியில்கள்
kaithigal	கைதிகள்
kaidhiyaaga	கியாதிக
kaidhiyaaka	கியாதியாக
kaithiyaaga	கைதியாக
kaidhiyin	கியிதின்
kaithiyin	கைதியின்
kaipesi	கைபெஷ்
kaypaesi	கைபேஷ்
kaimaari	கைமாரி
kaimari	கைவரி
kaiyaal	கையால்
kaiyal	கையால்
kaiyoppamittu	கையப்பெட்டும்
kaivasam	கைவசம்
kodoora	கோரத்தா
kodura	கொருத்
kodooramaaga	கொடுராமாக
kodooramaaka	கொடுராமாக
koduramaga	கொடுரமாக
koturamaka	கொடுராமாக
kodooramaana	கொடுராமன
koduramana	கொடுரமான
konarum	கோனரும்
kondirukka	கொண்டிருக்க
kontirukka	கொண்டிருக்க
kondirukkak	கொண்டிருக்கத்
kontirukkak	கொண்டிருக்கத்
kondirukkavillai	கொண்டிருவ்களைகில்
kontirukkavillai	கொண்டிருவ்களைகில்
kondirukkumpoadhu	கொண்டிக்குவ்ப்பது
kondirukkumpoothu	கொண்டிக்குவத்தும்
kodhikkum	கொதிக்கும்
kothikkum	கோதிக்கும்
kothikum	கொதிக்கும்
gaurila	கோரில்
gaurilla	கோரில்ல
gauurilla	கோரில்ல
gorila	கோரில்
gorilla	கோரில்
gorrila	கரியோல்
gorrilla	கொறில்லா
govrilla	கோரிவில்
gowrila	கோரிவில்
gowrilla	கோரில்ல
guarrilla	கூறில்லா
guerilla	கூரில்ல
guerrila	குரில்
guerrilla	குரில்லால்
gureila	குரியல்
gurila	கூரில்
gurilla	குரில்லா
guuerrilla	கூரில்லேல்
guureila	கூரியல்
guurilla	கூரில்ல
kaoorilla	கோரில்
kolal	கொலல்
kollal	கொல்ல்
kol	னுள்
koll	கொழில்
kolgiraargal	கொள்கிறார்கள்
kolkiraargal	கொள்கிறார்கள்
kolkiraarkal	கொள்கிறார்கள்
kollavum	கொள்ளவும்
kolladha	கொள்ளத
kollatha	கொள்ளத
kollaadhavar	கொள்ளதாவத்
kolladhavar	கொள்ளதாதவர்
kollathavar	கொள்ளதவதார்
kollaadhu	கொள்ளது
kolladhu	கொள்ளது
kollathu	கொள்ளது
kollvadhaal	கொள்வதால்
kolvadhaal	கொள்வதால்
kolvathaal	கொள்வதால்
kolukattai	கொழுக்கத்தை
kolukkattai	கொழுக்கத்தை
kozhukkattai	கொழுக்கத்தை
kolunthu	கொழுந்து
koluntu	கொழுந்து
kozhundhu	கொழுந்து
kolupil	கொழுப்பில்
koluppil	கொழுப்பில்
kozhuppil	கொழுப்பில்
colombin	கொழுப்பின்
columbin	குழம்பின்
columbu	கொழும்பு
kozhumbin	குழைம்புண்
colombil	கொழுப்பில்
columbil	கொழும்பில்
columbu	கொழும்பு
kozhumbil	கொழும்பில்
gokila	கோரிக்
koagilaa	கோழியா
koakila	கோரிக்
koatpaatu	கோட்பாடு
kootpaadu	கூட்டாபு
kootpaatu	கூட்டாப்
koatpaatukalin	கோட்பாடுகினால்
kootpaadugalin	கோட்பாடுகளின்
kootpaadukalin	கோட்பாடுகளின்
koatpaatukalum	கோட்பாடுகளும்
kootpaadukalum	கோட்பாடுகளும்
kootpaatukalum	கோட்பாடுகளும்
koatpaatukalai	கோட்பாடுகளை
kootpaadugalai	கோட்பாடுகளை
kootpaadukalai	கோட்பாடுகளை
kootpaatukalai	கோட்பாடுகளை
koatpaatum	கோட்பாடும்
kootpaadum	கோட்பாடும்
kootpaatum	கோட்பாட்டும்
gobi	னிப்
gobii	ரோபி
goobi	ரூப்
goopee	கோபே
goopi	ரூப்பி
goopy	கூப்பி
gopee	கோபே
gopi	ிரோப்
gopii	ரோப்பி
gopy	கோப்பி
koabi	ோபி
koapi	ோப்பி
kobi	னிப்
kofee	கோே
kofi	னிப்
kofii	ிரோப்
koofee	கூரை
koofi	ுபோரி
koophee	கூப்வே
koophi	ுபதி
koopi	ுப்பி
kophee	கோப்வே
kophi	னிப்
kophii	ரோப்பி
qofee	கோஷ்வி
qofi	னிப்
qophee	கோஷ்வை
qophi	னிப்
koappai	கோப்பை
koopai	கோபை
kooppai	கோப்பை
koppai	கோப்பை
koappaigalai	கோப்பைகளை
koopaikalai	கோபைகளை
kooppaigalai	கோப்பைகளை
kooppaikalai	கோப்பைகளை
koppugalai	கோப்புகளை
koappaigal	கோப்பைகள்
koopaikal	கோபைகள்
kooppaigal	கோப்பிகள்
kooppaikal	கோப்பிகள்
koppaigal	கோப்பைகள்
koappaikkaana	கோப்பைக்கான
koopaikkaana	கோபைக்கான
kooppaikkaana	கோப்பைக்கான
koppaikkaana	கோப்பைக்கான
koappaiyin	கோப்பையின்
kopaiyin	கோபையின்
koppaiyin	கோப்பையின்
koappaiyil	கோப்பையில்
kooppaiyil	கோப்பையில்
kopaiyil	கோபையில்
koppaiyil	கோப்பையில்
koappaiyai	கோப்பையை
koopaiyai	கோபையை
kooppaiyai	கோப்பையை
koppaiyai	கோப்பையை
colie	கோரியே
colii	ரூலை
colli	குரில்
collie	கொல்லி
collii	கோல்லி
colly	கோரில்
coly	ரிய்ல்
coollie	குழ்லை
coollii	கூழ்லை
coolly	கூர்லி
goalie	கோழிய்
goli	ருளை
golli	ார்லி
golly	கொழில்
goly	ரிய்ல்
gooalie	கோலையி
goolly	கூர்லி
koali	ருள்
koli	ருளை
kolli	ொருள்
kolly	கொழில்
koly	குரில்
kooli	ருள்
koolli	குழ்
koolly	கூர்லி
qolli	ார்லி
qolly	கொழில்
goliath	கோழியத்
golieth	கொழித்
gooliath	கூழியத்
kooliyat	கூழியத்
goalgalai	கோல்களை
goalkalai	கோழ்களை
kolgalai	கொள்களை
koolgalai	கோல்களை
koolkalai	கோல்களை
goldain	கொள்டைன்
goldan	கில்டன்
golden	குர்தலின்
gooldain	குர்தாலின்
gooldan	குர்தான்
goolden	குஷ்டன்
kooldan	குர்தல்
kooltan	குர்தல்
colt	கில்ட்
coolt	குர்த்
cooltt	குழ்த்து
cooult	குருத்
coult	குர்த்
couult	குருந்த்
gauld	குள்ளு
gauuld	குள்
gold	குள்
golda	கொள்ட
goold	ுர்த்
goolda	கோர்த்தா
goould	குருத்
gould	குள்ளு
gouuld	குருந்த்
kolt	குள்
koold	ுருத்
koolt	குள்
qolt	குள்
golf	ொகொல்
koolp	ுசல்
kolin	கிழனன்
koolin	குழின்
koovalanum	கோவலுும்
kovalanum	கோவலுும்
koovalan	கோவலன்
kovalan	கோவலன்
cauimbatoore	காய்முப்பூர்
cauimbatore	சாய்முப்பார்
cauimbetore	காய்முப்பேர்
cauuimbatore	கோயம்புதார்
coimbaatore	கோய்ம்பாத்தி
coimbaetore	கோய்ம்பெட்டர்
coimbatore	கோயம்பூர்தி
coimbetore	கோய்ம்பெர்ட்
cooimbaatoore	கோய்ம்போட்ரா்
cooimbatoore	கோய்முப்பூரி
covai	கோவை
koimbatore	கோய்ம்பூதர்
koimbetore	கோய்ம்பெர்ட்டர்
kooimbatoore	கோய்ம்பூரத்தி
koovai	கூவை
kovai	கோவை
qoimbatore	கோய்ம்பூதர்
covaiyin	கோவியைன்
koovaiyin	கோவையின்
kovaiyin	கோவையின்
covaiyil	கோவியல்
koovaiyil	கோவையில்
kovaiyil	கோவையில்
gaurava	கூரவவ
gowrava	கோவவி
kaurava	கூரவவ
gouravikkum	கோவரிக்கும்
gowravikkum	கோவரிக்கும்
gowrawikkum	கோவாிிக்கும்
kouravikkum	கோரவிக்கும்
cakkarangalai	சக்கரங்களை
cakkarankalai	சக்கரங்களை
chakkarangalai	சக்கரங்களை
chakkarankalai	சக்கரங்களை
sakkarangalai	சக்கரங்களை
sakkaranggalai	சக்கரங்களை
cakkarattin	சக்கரத்தின்
chakkarattin	சக்கரத்தின்
sakkaraththin	சக்கரத்தின்
cakkarattai	சக்கரத்தை
cakkaratthai	சக்கரத்தை
chakkarattai	சக்கரத்தை
chakkaratthai	சக்கரத்தை
sakkaraththai	சக்கரத்தை
cakkarattaip	சக்கரத்தாவி
cakkaratthaip	சக்கரத்தைப்
chakkaraththaip	சக்கரதததிப்
chakkarattaip	சக்கரத்தாய்
chakkaratthaip	சக்கரத்தியப்
sakkaraththaip	சக்கரததததி
chakravarthi	சக்ரவரித்தி
charavarththi	சரவர்த்தி
sakravarththi	சக்ரவரத்தி
sangak	சங்கக்
sangkak	சங்கக்
cankangalukku	சங்கங்களுக்கு
cankankalukku	சங்கங்களுக்கு
chankangalukku	சங்கங்களுக்கு
chankankalukku	சங்கங்களுக்கு
sangangalukku	சங்கங்களுக்கு
sangkangkalukku	சங்கங்களுக்கு
cankangalai	கணங்களை
cankankalai	கண்கங்களை
chankangalai	சங்கங்களை
chankankalai	சங்கங்களை
sangankalai	சங்கங்களை
sanggangkalai	சங்கங்களை
cankangal	சங்கங்கள்
cankankal	சங்கங்கள்
chankangal	சங்கங்கள்
chankankal	சங்கங்கள்
sangankal	சங்கங்கள்
sanggangkal	சங்கங்கள்
cankat	சனக்க
cankath	சங்கத்
chankat	சங்கத்
chankath	சங்கத்
sangath	சங்கத்
sanggath	சங்கத்
cankattirku	சங்கத்திற்கு
chankatthirku	சங்கத்திற்கு
sangaththirku	சங்கத்திற்கு
sanggaththirku	சங்கத்திற்கு
sangaththil	சங்கத்தில்
sanggaththil	சங்கத்தில்
sangaththai	சங்கத்தை
sanggaththai	சங்கத்தை
sangamathil	சங்கமத்தில்
sangamaththil	சங்கமத்தில்
sanggamaththil	சங்கமத்தில்
sankamathill	சங்கமத்தில்
sangamam	சங்கமம்
sanggamam	சங்கமம்
sankamam	சங்கமம்
sankamum	சந்கமும்
sangamaaga	சங்கமாக
sangamaaha	சங்கமா
sangamaga	சங்கமாக
sangamaha	சங்கமா
sanggamaaga	சங்கமாக
sangamekkum	சங்கமேக்கும்
sangamigum	சங்காமிக்கும்
sangamikkum	சங்காமிக்கும்
sanggamikkum	சங்காமிக்கும்
sankamikkum	சங்காமிக்கும்
sangamoom	சந்காமம்
sangamum	சங்கமும்
sanggamum	சங்கமும்
sankamum	சந்கமும்
sangavai	சங்கவை
sangavi	சங்கவி
sangili	சங்கிலி
sangily	சங்கிலி
sangkili	சங்கிலி
sanggiligal	சங்கிலிகள்
sangiligal	சங்கிலிகள்
sangilikal	சங்கிலிகள்
sanggiliyaal	சங்கிலியால்
sangiliyaal	சங்கிலியல்
sangiliyal	சங்கிலியல்
sanggiliyai	சங்கிலையி
sangiliyai	சங்கிலையை
sangilyyai	சங்கிலையை
cankai	கன்சை
chankai	சங்கை
sangai	சங்கை
sattama	சந்தா
sattamaa	சட்தாம
sattai	சட்டை
sattaiyin	சட்டையின்
sattaiyil	சட்டையில்
sattaiyai	சட்டையை
sadhaveedhaththil	சதவேததததில்
sathaveethaththil	சதேவததததில்
sadhaveedham	சதேவதிதம்
sadhaveetham	சதேவததம்
sathaveetham	சதேவததம்
sadhi	சநதி
satee	ச்றியே
sathi	ச்தி
sati	ச்டி
satii	ச்டி
satti	ச்டி
setee	ச்றியே
seti	சிட்
setii	ச்டி
setti	ச்டி
satees	ச்டியேஷ்
sateesh	செடிதேஷ்
satheesh	சத்தேஷ்
sathis	ச்தித்
sathish	சத்திஷ்
satiis	ச்டிதி
satiish	செடிஸ்
satis	ச்டிஸ்
satish	சத்திஸ்
setees	ச்டியேஷ்
setiis	ச்டித்
setis	ச்டிஸ்
sathya	சந்தியா
sathyaavin	சாதியாவின்
sathyavin	சாதியவின்
santharppangalil	சந்தர்பங்களில்
santharppangkalil	சந்தர்பங்களில்
santharppankalil	சந்தர்பங்களில்
santharppangalai	சந்தர்பங்களை
santharppangkalai	சந்தர்பங்களை
santharppankalai	சந்தர்பங்களை
santharppangal	சந்தர்பங்கள்
santharppangkal	சந்தர்பங்கள்
santharppankal	சந்தர்பங்கள்
santharppaththil	சந்தரப்பத்தில்
santharppam	சந்தரப்பம்
sandhia	சந்தியா
sandhiaa	சந்தியா
sandhiya	சந்திய
sandhya	சந்திய
sandhyaa	சந்தியா
santhaippaduththal	சந்தைப்புத்தல்
sabari	சபாரி
sabaiyinaal	சபையினால்
chamakaala	சமாகவா
samakaala	சமாகவா
samanaana	சமனான
samanana	சமனான
samapangku	சமபஞர்க்
samamaaga	சமமாக
samamaga	சமமாக
samamaka	சமமாக
samamaagavum	சமாமாகவும்
samamagavum	சமாகவும்
samamakavum	சமாமாகும்
samayath	சமயாத்
samarppiththaar	சமர்பித்தார்
samarppiththu	சமர்பித்து
samarppiththullaar	சமர்பித்துள்ளார்
samaiththa	சமைத்த
samayththa	சமயத்த
saimaiththal	சைமைத்தல்
samaiththal	சமைத்தல்
samayththal	சமயத்தல்
samaiththaal	சமைத்தால்
samayththaal	சமயத்தால்
sam	ச்சம்
sum	சும்
samsaaram	சம்சரம்
samsaram	சம்சரம்
sambiradhaaya	சம்பிரதாய
sambradhaaya	சம்பதராய
sambrathaaya	சம்பரதாயா
sampirathaaya	சம்பிரதாய
sampirathaya	சம்பிரத்தாயா
samprathaaya	சம்பர்தாய
sambiradhayamaana	சம்பிரதமான
sambirathaayamaana	சம்பிரதமானாய
sambradhayamaana	சம்பதிராயமான
sambrathaayamaana	சம்பதிராாயவ
sampirathaayamaana	சம்பிரதாயான
sammandhdhar	சமமந்தத்த
sammanthar	சம்மந்தர்
sarakkugal	சரக்குகள்
sarakkukal	சரக்குகள்
saranadaintha	சரணதாத்தி
saranadainthathu	சரணதானத்து
saranadainthaar	சரணத்தான்ற
saranadainthar	சரணதான்திர
saranadainthu	சரணதான்து
curender	குரெண்டர்
currendar	குரெண்டர்
currender	குரெண்டர்
cuurrender	குராந்திர்
saranadaiya	சரணடைய
sarendar	சரிந்த
sarrendar	சரரந்தெர்
surendar	சுரெண்டர்
surendarr	சுரெந்தர்
surender	சுரெந்திர்
surenderr	சுரெந்திர்
surrendar	சுரெர்ந்த
surrender	சுர்நேத்தி
suurenderr	சுரந்திர்
suurrendar	சுர்நேத்த
suurrender	சுர்நேத்தி
sarayu	சரையு
saralamaaga	சரலமாக
saralamaaka	சரலமாக
saralamaka	சரலமாக
sarala	சரலா
saravanabavan	சரவவனான்
saravanabhavan	சரவவனசன்
saravanapavan	சரவவனாசன்
saritham	சரிதம்
saritha	சரித்த
roaga	ரோக்கு
roaka	ரோக்கு
roka	ரோக்கு
rooka	ரோக்கா
sarva	சர்வா
sarvam	சர்வம்
sarvarukku	சர்வருக்கு
servarukku	செர்வருக்கு
serverukku	செர்வேறுக்கு
sarvar	சர்வர்
sarvur	சருவத்
sarwar	சர்வர்
servar	சிர்வர்
server	சுர்வெ்
servur	சுர்வுத்
servuur	சிர்வூத்
serwar	சிர்வர்
serwer	சுர்வெ்
serwur	சிருவ்்
survar	சுர்வர்
surver	சுற்வர்
surwer	சுர்வெ்
suurver	சுர்வே்
sarvargal	சர்வர்கள்
sarvarkal	சர்வர்கள்
servergal	சேர்வெற்கள்
serverkal	சேர்வெற்கள்
satruth	சற்றுத்
sattruth	சற்றுத்
satrup	சற்றுப்
sattrup	சற்றுப்
satrum	சற்றும்
sattrum	சற்றும்
satre	சற்றி
sattrae	சற்றை
sattre	சற்றி
saasana	சோன
sasana	சநாய்
saasanangal	சசானங்கள்
saasanankal	சசானங்கள்
sasanangal	சசனங்கள்
sasanankal	சசனங்கள்
saasanaththin	சசாதனத்தின்
sasanaththin	சசனத்தின்
saasanaththil	சசாநதத்தில்
sasanaththil	சசனத்தில்
saanjchi	சஞ்சி
saanji	சனனி
sanchi	சனனி
sanji	சஞனி
saandoa	சாந்து
sando	சந்து
santo	சந்து
saadhagam	சாதகம்
saathakam	சாதகம்
sathakam	சதகமு
saadhaaranamaana	சாதாரானான
saathaaranamaana	சாதாரானான
saaththiyamaa	சாத்தியமா
chaantha	சன்த
kumaari	குமாரி
kumari	ுகராத்
saantha	சனந்த
saanthan	சிந்தன்
santhan	சந்தின்
saanthappaduththum	சாந்தப்படுத்தும்
saanthappaduthum	சாந்தப்படுதும்
saantham	சாந்தம்
santham	சந்தம்
sanththam	சந்தம்
saamaaniya	சாமானிய
caaminaathan	சாமினாதன்
chaaminaathan	சாமிதானன்
saaminaadhan	சாமிதானன்
saaminaathan	சாமிதானன்
saaradhigal	சாரதிகள்
saarathigal	சாரதிகள்
saarathikal	சாரதிகள்
saradhigal	சரதிகள்
sarathigal	சரதிதால்
sarathikal	சரதிகள்
chaallukiyar	சாலுகியிர
chalukkiyar	சுழக்கியார்
chalukyar	சுலகிர்
saallukiyar	சாலுகியார்
saalukkiyar	சாலுக்கியார்
sallukiyar	சொல்கியார்
chalukiyargal	சொழுகியார்கள்
chalukkiyarkal	சொழுக்கியார்கள்
chalukyargal	சுலகிராக்
saalukkiyargal	சாலுக்கியர்கள்
saalukkiyarkal	சாலுக்கியர்கள்
salukkiyarkal	சழுக்கியர்கள்
kei	ெய்
key	ையி
qey	ையி
saavi	சிவா
saavithri	சாவிதிர்
savithri	சாவித்தி
savitri	சாவிர்தி
saashthiri	சாஸ்திரி
saasthiri	சாத்திரி
sasthri	ச்சதிரி
sastree	ச்றதே
sastri	சாத்திரி
sastrii	சாத்திரி
sastrree	சாத்தீரி
sastrrii	சாத்திரி
shastree	சாத்திரியா
shastri	சாத்திரி
shastrree	சாத்திரே
saashthirigal	சாஸ்திரிகள்
saasthirigal	சாஸ்திரிகள்
sasthirigal	சஸ்திரிகள்
shashthrigal	சாஸ்திரிகள்
chikkana	சிக்கான
sikana	சிகான
sikkana	சிக்கான
chikkanamaaka	சிக்கமானாக
sikanamaka	சிகாமாக
sikkanamaaga	சிக்கமானாக
sikkanamaaka	சிக்கமானாக
chikkanamaana	சிக்கமானான்
sikanamana	சிகனமான
sikkanamaana	சிக்கமானான்
chittu	சிட்டு
seetu	சியுடு
seetuu	சிறுது
siitu	சியோது
sito	சியோது
sitoo	சிதோ
sittu	சிட்டு
situ	சியுது
situu	சியுடு
chittuk	சிட்டுக்
sittuk	சிட்டுக்
seeddharth	சீத்தத்
seedharth	சீதர்த்
seidharth	செய்தத்த்
seydharth	செயத்து
siddharth	சித்திர்
sidharth	சிதரத்த்
sidharthh	சிதரத்த்
siiddharth	சீத்திரத்
siththaarth	சித்தார்த்
sittharth	சித்தர்
chithirai	சிதிரை
sithirai	சிதிரை
siththirai	சித்திரை
sitthirai	சித்திரை
chithiraip	சிதிரைப்
sithiraip	சிதிரைப்
siththiraip	சித்திரைப்
sitthiraip	சித்திரைப்
chinthitthal	சிந்தித்தல்
sinthithal	சிந்திதல்
sinthiththal	சிந்தித்தல்
sinthitthal	சிந்தித்தல்
caardu	சரித்து
card	யிருத்
kaardu	கரித்து
kartu	யற்து
sim	சிம்
shimman	ிிமம்
simman	சிமம்
simmon	சிமுமன்
chims	சிஸ்ம்
semms	சும்ம்
sems	சுஷ்
siims	சிஸ்ம்
simms	சிம்ம்
sims	சிஸ்ம்
simss	சிஸ்ஸ்
symms	சிமம்
syms	சும்
siraaj	சிராஜ்
siraj	சிரில்
sirian	சிறின்
syrian	சிரியன்
syriyan	சிறியன்
siriap	சிறிப்
siriyap	சிறியப்
syriap	சிறியப்
syriyap	சிறியப்
siridhalavu	சிறிதளவு
siridhazhavu	சிறிதளவு
sirithalavu	சிறிதளவு
siridhu	சிறிது
sirithu	சிறிது
siridhum	சிறிதும்
sirithum	சிறிதும்
seelica	சிலியா
siilica	சிலியா
silica	சிலியா
silicca	சிழிக்கா
silika	சிலிக
siliqa	சிலிக்கா
silicon	சிலியூன்
silikkaan	சிலிக்கான்
silikon	சிலிக்கோ
shiiv	ிிய்்
shiv	ிஸ்வு
shiva	ஷிவாதி
siiv	ிிய்்
siiw	சிவித்
siv	ிஸ்வு
siva	சிவி
siw	சிவித்
siwa	சிவி
sivandhu	சிவந்து
sivanthu	சிவந்து
sivanin	சிவனின்
sivanukku	சிவனுக்கு
sivaperumaanae	சிவபெருமான
sivaperumane	சிவமெபுரினம்
sivappiragasa	சிவப்பிராச
sivappirakaasa	சிவப்பிராாச
sivappirakasa	சிவப்பிரசாம்
sivapragasha	சிவபர்சா
sivaprakasa	சிவபர்கா
sivam	சிவம்
secret	சுற்றேத்
seekraet	சிற்கேட்
seedhakkadhi	சீதக்கத்தி
seedhakkathi	சீதக்கத்தி
seethakathi	சீதாதத்தி
seethakkaathi	சீதக்கத்தி
seethakkadhi	சீதக்கத்தி
seethakkathi	சீதக்கத்தி
seenivasa	செனிவவ
srinivasa	ஸ்ரீனிவாசா
chiirutai	சிறுத்தை
chirutai	சிறுதை
seerudai	சுரைது
serutai	சுரைத்து
siirutai	சிறுத்தை
cheerutaikal	சீருதையுகள்
seerudaigal	சீருடைகள்
seerudaikal	சீருடைகள்
chiirutaip	சிறுதைப்
chirutaip	சிறுதைப்
seerudaip	சீருடைப்
serutaip	சுரைத்துப்
siirutaip	சிறுதைப்
seelam	சிலம்
seelaa	சிலா
sheela	சில்
chukku	சுக்கு
sukku	சுக்கு
chudalai	சூடலை
sudalai	சூடலை
chutalaimaatan	சூடலாயும்
sudalaimaadan	சுடலையமான்
sudalaimadan	சுடலையமன்
sudalaimatan	சுடலையமன்
sutalaimaatan	சூடலாயமுடன்
chutthappadutthum	சுத்தப்படுத்தும்
sudhthappaduththum	சுத்தப்படுத்தும்
suthapaduthum	சுதப்படுத்தும்
suththappaduththum	சுத்தப்படுத்தும்
sutthappadutthum	சுத்தப்படுத்தும்
chuthamaana	சுதமான
suthamaana	சுதமான
suthamana	சுதமான
suththamaana	சுத்தமான
sundari	சுந்தரி
sundhari	சுந்தரி
sunthari	சுந்தரி
suba	ூசுப்
subaa	சுபா
subha	சுப்பா
suraakkal	சுராக்கள்
chutrtrivara	சுற்றிவர்
surrivara	சுறிவிரா
sutrivara	சுற்றிவர்
sutrtrivara	சுற்றிவர்
suttrivara	சுற்றிவர்
surrullaa	சுற்றுள்ள
sutrullaa	சுற்றுள்ள
suttrulaa	சுற்றுளா
payanigalai	பயனிகளை
payanikalai	பயனிகளை
payanikalaip	பயனிகளைப்
surrullaap	சுற்றுள்பால்
sutrullaap	சுற்றுள்பால்
suttrulaap	சுற்றுளால்
chuvarin	சுவரின்
suvarin	சுவரின்
chuvarkal	சுவர்கள்
suvargal	சுவர்கள்
suvarkal	சுவர்கள்
suvaasikka	சுவாசிக்க
suvachikka	சுவாசிக்
suvasikka	சுவாசிக்
suvaasikkum	சுவாசிக்கும்
suvachikkum	சுவாசிக்கும்
suvasikkkum	சுவாசிக்கும்
choottik	சுட்டிக்
chuttik	சுட்டிக்
shoottik	சுட்டிக்
soottik	சுட்டிக்
choottinaar	சூட்டினார்
chuttinar	சுட்டினர்
shoottinaar	சூட்டினார்
soottinaar	சூட்டினார்
soottinar	சூட்டினர்
choothaattam	சோதாத்தம்
soodhaattam	சோதாத்தம்
soothaattam	சோதாத்தம்
sooraavaligal	சூரவவில்கள்
sooraavalikal	சூரவவில்கள்
sooravazhigal	சூரவளிகள்
sooraavaliyil	சூரவவலியில்
sooravaliyil	சூரவவிலையில்
suravaliyil	சுரவளியில்
suravazhiyil	சுரவளியில்
soolappattadhu	சூலப்பட்டது
soolappattathu	சூலப்பட்டது
soozhappattadhu	சூழப்பட்டது
soozhappattathu	சூழப்பட்டது
soolappattullathu	சூலப்பட்டுள்ளது
soozhappattullathu	சூழப்பட்டுள்ளது
suzhappattullathu	சூழப்பட்டுள்ளது
sengkuththaana	செங்குத்தான
sengkutthaana	செங்குத்தான
senguththaana	செங்குத்தான
senkuththaana	சென்குத்தான
chengai	சென்கை
sengai	சென்கை
chenchi	சனனி
gingee	ிக்சி
senchi	சனனி
senjchi	சஞ்சி
senji	சனனி
centar	சிந்து
center	சிந்து
centre	சென்றே
saentar	சென்டர்
sentar	சென்டர்
centi	சின்டி
senti	சன்டி
caent	னியுட்
cent	னிய்டு
scent	சுட்ந்
send	சனந்து
sent	சனந்து
jeppelin	ஜெப்பிலிங்
zepelin	ஜெலிபின்
zeppelin	ஜெப்பிலிங்
seyarpaadu	செயற்பாடு
seyarpadu	செயற்படு
seyarpaadugalin	செயற்பாடுகின்
seyarpaadugalilum	செயற்பாடுளிலும்
seyarpadugalilum	சேயற்பாடுளிலும்
seyarpaadugalil	செயற்பாடுகளில்
seyarpaadugalukkaana	சேயற்பாடுகளுக்கான
seyarpaadugalukku	செயற்பாடுகளுக்கு
seyarpaadugalum	செயற்பாடுகளும்
seyarpadugalum	செயற்பாடுகளும்
seyarpaadugalai	செயற்பாடுகளை
seyarpaadugalaik	செயற்பாடுகளைக்
seyarpadugalaik	செயற்பாடுகளைக்
seyarpaadugalaiyum	செயற்பாயுகளையும்
seyarpadugalaiyum	செயற்பாயுகளையும்
seyalaatra	செயலாற்ற
seyalaattra	செயலாற்ற
seyalatra	செயலார்ற
seyalilandhdhu	செயலிந்தது
seyalilanthu	செயலிலந்து
seyalizhandhdhu	செயலிலந்தது
seyalizhandhu	செயலிலந்து
seyalizhandu	செயலிலந்து
seyalukkaaga	செயலுக்காக
seyalukkaga	செயலுக்காக
seyalpadaatha	செயல்பாடத்
seyalpadadha	செயல்படாத
seyalpadatha	செயல்படாத
seyalpatatha	செயல்படாத
seyalpadudhal	செயல்படுதல்
seyalpaduthal	செயல்படுதல்
cheyalpadum	செயல்பாடும்
seyalpadum	செயல்பாமு
seyalpatum	செயல்பாடும்
cheyalpatumpoothu	செயல்பாப்பூடும்
cheyalpatumpothu	செயல்பாப்புதும்
seyalpadumpoathu	செயல்பாப்பூடும்
seyalpadumpodhu	செயல்பாப்புது
seyalpadumpothu	செயல்பாபுதும்
seyalpatumpoothu	செயல்பாப்பூதும்
cheyalpaduvathu	செயல்பாவுடு
seyalpaduvadhu	செயல்படுவது
seyalpaduvathu	செயல்படுவது
seyalpatuvathu	செயல்பாவுடு
cheyalmuraikalai	செயல்முறைகளை
seyalmuraigalai	செயல்முறைகளை
seyalmuraikalai	செயல்முறைகளை
cheyalmuraikal	செயல்முறைகள்
seyalmuraigal	செயல்முறைகள்
seyalmuraikal	செயல்முறைகள்
cheyalmuraikku	செயல்முறைக்கு
cheyalmuraiku	செயல்முறைக்
seyalmuraikku	செயல்முறைக்கு
cheyalmuraiyil	செயல்முறையில்
seyalmuraiyil	செயல்முறையில்
cheyalmuraiyai	செயல்முறையை
seyalmuraiyai	செயல்முறையை
cheyint	செயிந்து
saent	சிந்து
saint	சைந்து
saintt	செய்ந்து
seint	சென்டு
sent	சனந்து
sentt	சென்டு
seyint	செயிந்து
chain	சியன்
chayn	சியன்
chein	சியின்
cheinn	சின்டு
chen	ியன்
cheyin	சியின்
cheyn	சியன்
cheynn	சின்
seyin	சியின்
seithathin	செயத்தின்
cheythamaiyaal	செய்தமையால்
cheythamaiyal	செய்தமையை
seidhamaiyaal	செய்தமையால்
seithamaiaal	செய்தமையால்
seithamaiyaal	செய்தமையால்
seythamaiyaal	செய்தமையால்
cheythavarukku	செய்தவருக்கு
cheythavaruku	செய்தவருக்கு
seidhavarukku	செயதவருக்கு
seithavarukku	செய்தவருக்கு
seythavarukku	செய்தவருக்கு
seidhullaargal	செய்துள்ளார்கள்
seithullaargal	செய்துள்ளார்கள்
seithullaarkal	செய்துள்ளார்கள்
seibavar	செயப்பவர்
shipper	சிப்பர்
siper	சிப்பர்
sippar	சிப்பர்
sipper	சிப்பர்
seibavargalae	செய்பவர்களை
seibavargale	செய்பவர்கள்
seibavarkale	செய்பவர்கள்
seibavargal	செய்பவர்கள்
seibavarkal	செய்பவர்கள்
seimadhi	செய்மதி
seimathi	செய்மதி
seiyappatta	செய்யப்பட்ட
seiyyappatta	செய்யப்பட்ட
seiyappattathaaga	செய்யப்படத்தாக
seiyappattathaaka	செய்யப்படத்தாக
seiyyappattadhaaga	செய்யப்படத்தாக
seiyyappattathaaka	செய்யப்படத்தாக
seiyappattathu	செய்யப்பட்டது
seiyyappattadhu	செய்யப்பட்டது
seiyyappattathu	செய்யப்பட்டது
seiyappattathum	செய்யப்பட்டதும்
seiyyappattadhum	செய்யப்பட்டதும்
seiyyappattathum	செய்யப்பட்டதும்
seiyappattanar	செய்யப்பட்டனர்
seiyyappattanar	செய்யப்பட்டனர்
seiyappattapoothu	செய்யப்படுத்தோது
seiyappattapothu	செய்யப்படுத்து
seiyyappattapodhu	செய்யப்படப்படு
seiyyappattapothu	செய்யப்படத்துவு
seiyappattavudan	செய்யப்படுவடன்
seiyyappattavudan	செய்யப்பட்டவுடன்
seiyappattavai	செய்யப்படவை
seyyappattavai	செய்யப்படவதை
seiyappattaan	செய்யப்பட்டனன்
seiyappattan	செய்யப்பட்டன்
seyyappattan	செய்யப்பட்டன்
seiyappattaar	செய்யப்பட்டார்
seiyappattar	செய்யப்பட்டர்
seyyappattar	செயய்பப்பட்ட
seiyappattaalum	செய்யப்பட்டுளம்
seiyappattalum	செய்யப்பட்டுள்ள
seyyappattalum	செய்யப்பட்டும்
seiyappattirundha	செய்யப்பட்டிருந்த
seiyappattiruntha	செய்யப்பட்டிருந்த
seyyappattiruntha	செய்யப்பட்டிருந்த
cheyyappattu	செய்யப்பட்டு
seiyappattu	செய்யப்பட்டு
seiyyappattu	செய்யப்பட்டு
seyyappattu	செய்யப்பட்டு
seiyappattullaar	செய்யப்பட்டுள்ளன
seiyappattullar	செய்யப்பட்டுள்ள
seyyappattullar	செயய்பாப்டுட்ள்ள்
seiyul	செயிலு
seyyul	செயுள்
seiyulgal	செய்யுள்கள்
seyyulgal	செயுள்கள்
seyyulkal	செயுள்கள்
cherbiya	சற்பிய
cherbiyaa	சிற்பய
sarbbiis	சர்பிப்
sarbia	சர்பிய
sarbiya	சர்பிய
serbbiis	சேர்பிப்
serbia	சிற்பை
serbiia	சர்பியை
serbiis	ச்பிரிஷ்
serbiya	சற்பிய
serbiyaa	சற்பியா
cherinthu	செறிந்து
serindhu	செரிந்து
serinthu	செரிந்து
chelavidum	செலவிடும்
selavidum	செலவிடும்
cheluthinar	செலுத்தினர்
chelutthinar	செலுத்தினர்
seluthinar	செலுத்தினர்
seluththinar	செலுத்தினர்
selutthinar	செலுத்தினர்
sevvaai	ச்வவவாி
sevvaaik	செவ்வாய்
segariththu	சேகரித்து
sekariththu	சேகரித்து
segarippadhil	சேகரிப்பதில்
sekarippathil	சேகரிப்பதில்
segarippadhu	சேகரிப்பது
sekarippathu	சேகரிப்பது
segarippu	சேகரிப்பு
sekarippu	சேகரிப்பு
segaripputh	சேகரிப்பத்
sekaripputh	சேகரிப்பத்
chaethamadainththa	சேதமைந்தத்
saethamadainththa	சேதமைந்தத்
sedhamadaindha	சேதமைந்தத்
sethamadaindha	சேதமமைந்த
chaethamadainththu	சேதமைந்தது
saethamadainththu	சேதமைந்தது
sedhamadaindhu	சேதமைந்து
sethamadaindhathu	சேதமைந்தது
chaethamadainththana	சேதமைந்ததன்
saethamadainththana	சேதமைந்தடன்
sedhamadaindhana	சேதமைந்தன்
sethamadaindhana	சேதமயந்தன்
saei	சை
saey	சியா
sei	சியா
sey	சியா
cheralaathan	செராளத்
saeralaathan	சேராளத்
saeralathan	சேரளத்தன்
seralathan	சேரளத்தன்
chairil	சைரில்
saeril	சுறில்
saerkkai	சார்க்கை
serkkai	சர்க்கை
saerkkaigal	சேர்க்கைகள்
serkkaikal	சேர்க்கைகள்
saerkkaiyaal	சேர்க்கையால்
serkkaiaal	சேர்க்காயல்
serkkaiyaal	சேர்க்கையால்
saerkkaiyin	சேர்கையின்
serkkaiin	சேர்கைகின்
serkkaiyin	சேர்கையின்
saertkkiyai	சேர்க்கையை
serkaiai	சேர்கையை
serkkaiyai	சேர்கையை
saerththuch	சேர்த்துச்
serththuch	சேர்த்துச்
saerththum	சேர்த்தும்
serththum	சீர்த்தும்
saernthu	சேர்ந்து
serndhu	சிர்ந்து
sernthu	செர்ந்து
saigai	சையை
syigyi	சியை
saigaigal	சைகைகள்
saigaikal	சைகைகள்
saikaigal	சைகைகள்
saikaikal	சைகைகள்
cybe	சியப்
cype	யிஸ்
saip	சைப்
sybe	செப்
sype	ஷெய்
saaiman	சியமு
seiman	சியம்
simon	சிமுன்
symon	சுமின்
sailaja	சைலா
sailajaa	சைலாஜா
shailaja	சைலாஜ்
cittanta	சிட்டுந்த
siththaantha	சித்தான்த
siththandha	சித்தந்த
saivak	சைவாக்
saivath	சைவத்
pirakaasa	பிரகாச்
pirakaca	பிரகா்
saivam	சைவம்
saivargal	சைவர்கள்
saivarkal	சைவர்கள்
sothai	சோதை
soththai	சொத்தை
sonthamaa	சநநததாம்
chollukkaana	சொல்லுக்கான
cholukana	சொழுகளன
sollukkaana	சொல்லுக்கான
chollukku	சொல்லுக்கு
choluku	சுழுது
sollukku	சொல்லுக்கு
chollunkal	சொழுல்ந்கள்
cholunkal	சுழங்குல்
sollungkal	சொழுல்களுக்
sollunkal	சொழுல்களு
cholludan	சொல்துடன்
chollutan	சொல்துடன்
choludan	சுலதுடன்
solludan	சொல்துடன்
solvadhaga	சொல்வதாக
solvathaaga	சொல்வதாக
solvathaaka	சொல்வதாக
solvathaga	சொல்வதாக
cholvathu	சொல்வது
solvadhu	சொல்வது
solvathu	சொல்வது
solvavathu	சொல்வவது
cholvathenraal	சொல்வதினார்கள்
solvadhenral	சொல்வதினர்கள்
solvathenraal	சொல்வதினர்கள்
solvathenral	சொல்வதினர்
solvathentraal	சொல்வத்தின்றால்
cholvathai	சொல்வதை
solvadhai	சொல்வதை
solvathai	சொல்வதை
soasalisa	சோசலிய
socialisa	சோசிலியா
sosalisa	சோசலிய
choathikkum	சோதிக்கும்
soathikkum	சோதிக்கும்
sothikkum	சோதிக்கும்
choazhapuram	சோழப்பும்
cholapuram	சொலப்புரம்
chozhapuram	சோழப்பு
soazhapuram	சோழப்பு
solapuram	சொலப்பும்
sozhapuram	சோழப்பும்
choazhar	சுர்
cholar	சுர்
chozhar	சுனர்
soazhar	சுர்
sozhar	சுனர்
choazharkalin	சோர்களின்
cholarkalin	சுலர்களின்
chozhargalin	சுழர்களின்
soazharkalin	சோழர்களின்
solarkalin	சுலர்களின்
sozharkalin	சோழர்களின்
choazharkalukku	சோர்களுக்கு
chozhargalukku	சோழர்களுக்கு
soazhargalukku	சோழர்களுக்கு
soazharkalukku	சோழர்களுக்கு
solarkalukku	சோலர்களுக்கு
sozharkalukku	சோழர்களுக்கு
choazharkal	சோரல்கள்
cholargal	சுலர்கள்
chozhargal	சுரங்கள்
soazhargal	சோழர்கள்
soazharkal	சோழர்கள்
solarkal	சுலர்கள்
sozharkal	சோழர்கள்
choudhri	சுரித்தி
chowdhri	சுவிதி
chowdhry	சுதிரி
chowthri	சுவிர்
southri	சுத்திரி
japanin	ஜபபினன்
jappaanin	ஜப்பானின்
japanai	பஞ்சா
jappaanai	ஜப்பானை
jaapaan	ஜாபன்
jaapan	ஜபபன்
japaan	ஜபபான்
japan	ஜபபன்
jappaan	சப்பான்
jappan	சபபின்
zaapaan	ஜாப்ப்
zaapan	சிபன்
zapaan	சாபன்
zapan	சுபன்
jappaar	சப்பார்
jaadhav	சாவித்
jaathav	யாதவு
jadav	கணவ்
jaanukku	ஜானுக்கு
jhonukku	சோனுக்கு
johnukku	ஜோன்சுக்கு
jaaliyan	ஜியாலின்
jaliyan	ஜியலின்
jallian	ஜில்லியன்
jolyan	ஜியோல்
jeeva	ஜியவு
nathi	நித்தி
nati	ணிட்டு
jeevaathmaa	ஜீவாத்தும்
jeevathma	ஜேவத்தும்
jaed	ஜிய்
jaet	ிய்
jait	ைய்த்
jed	ியோத்
jet	னிய்
jett	ஞ்செட்
zaet	னை
zait	ைய்த்
zed	ியுட்
zet	னிய்
zett	ஞ்செட்
gen	ியங்
jaen	ஜியன்
jain	ஜையின்
jayn	ஜியன்
jeen	ியின்
jen	ியன்
jenn	ஜின்
zain	யின்
zayn	யின்
zeen	ியின்
zen	ியின்
zenn	ினுஷ்
jaennr	ஜனன்
jener	னியர்
jennar	னின்
jenner	ஜனன்
zenner	ஜனன்
jane	ஜனே
jean	ஜியோன்
jen	ியன்
joordan	ஜுர்த்
jordaan	ஜர்தான்
jordan	ஜரண்டு
jorddan	ஜர்டுடன்
jurdan	ஜுர்தான்
zoorann	ஜுரனன்
zoordan	ஜுர்தான்
zoorddan	ஜூர்டன்
zordan	ஜர்டன்
zorddan	ஜர்டுடன்
joarthaan	ஜோர்தான்
jordan	ஜரண்டு
jorthaan	ஜூர்தான்
touff	டுப்
tough	டுஷ்
daglas	டாக்கா
daklas	டாக்கோ
daklus	டுக்லஸ்
douglas	டுக்ளோ
douglass	டாக்ஸ்
douuglas	டுகாலி
douuglass	டாக்ஸல்
duglas	டுக்ளா்
duglus	டுக்கிலோ
duuglas	டுக்ளா்
duugluus	குருல்
taklas	டாக்கா
taklash	கல்லாஷ்
taklus	டுக்கால்
darpoo	தறபோ
tarbo	டறபூர்
tarboo	தறபூ
turbau	தறுப்
turbo	டுரப்
turboo	டறுப்போ
tuurbauu	தூரைபு
tuurbo	டுரப்
daadaa	டாயா
taata	நாத்தி
taataa	நாத்தா
taeta	டியாது
taetaa	தியா
tata	நத்து
tataa	நாத்தா
teta	டியோ
tetaa	நத்தா
dance	டன்சி
dans	டின்
taans	தன்ஸ்
tains	டின்சு
tans	னிஸ்
tens	டின்ஸ்
torch	டரிச்
daarvin	திர்வின்
daarwin	திர்வின்
darvin	டரவின்
darvinn	டரிவின்
darvyn	டரவின்
darwin	டரவின்
darwinn	டரிவின்
darwyn	டரிவின்
taarvin	தரிவின்
doon	னிடன்
dun	னிடு
duun	னிட்
toon	னுஷ்
toonn	னின்
toun	னுஷ்
touun	ருண்
tun	னிடு
tunn	ினுடன்
tuun	னுட்
decsaas	தாஸ்காஸ்
teksaas	தெக்ஸா்
texas	டிசா்
daeevid	டிவெட்
daevid	டிவெட்
daewid	டிவெட்
david	டிவிட்
davidd	டிவிட்
dawid	டிவிட்
dawidd	டிவிட்
deevid	ீரிவுட்
devid	டிவெட்
dewid	டிவெட்
tevid	டிவிடு
davidson	டவிஸ்துன்
dawidson	டாவிஸ்தன்
tevitsan	திவிட்சன்
daai	டியா
daaii	டியோ
dae	டியா
dai	டியா
daie	டியே
daiie	டியே
dee	டியே
die	டியிலே
diie	டியிலே
dye	டியே
taai	டியா
tae	றை
tai	டியா
tie	ரிய்தே
daiddaniyam	டிட்டியாயன்
taitanium	தட்டையின்
taitaniuum	தட்டையோனும்
tetanium	தடனிடமியு
tietanium	திடனியம்
tietaniuum	திடனியும்
tightaniam	திட்டானியம்
tiitanium	தின்டையும்
tiitaniuum	தின்டையோம்
titaniam	தின்டையம்
titanium	தின்டையும்
titaniumm	தினடியமம்
titaniuum	தின்டையோம்
titaniuumm	தின்டையும்
dailar	டியலர்
tailer	டைஸ்ளி
tiler	திலிர்
tylar	டியுள்
tyler	டியூல்
daoopakoo	டோபோது
tabago	நாப்போ
tabagoo	நாபூதோ
tobaggo	தோபக்
tobago	தோபா
tobagoo	தோபாசு
tobagu	தோபு
toobaggoo	தூபாகோ
toobagoo	தூபாசு
dhonee	நோதே
dhoni	னின்
dhonii	தனி
dhoonee	தனே
dhooni	னூரி
dhoonii	தூனி
dhuni	ினுதி
doani	டினோ
donie	டினோ
donnie	டனனி
dooni	டினோ
doonnie	டனனி
toni	னிடி
tonii	னிடி
tony	னிடி
tooni	னூரி
toonii	னூடி
toony	னூரி
thangich	தங்கிச்
thankich	தங்கிச்
thangiya	தங்கிய
thangkiya	தங்கிய
thankiya	தன்கிய
thangiullathu	தங்கிலுள்ளது
thangiyulladhu	தங்கியுள்ளது
thangiyullathu	தங்கியுள்ளது
thankiyullathu	தங்கியுள்ளது
thadangalil	தடங்களில்
thadanggalil	தடங்களில்
thadangkalil	தடங்களில்
thadaya	தடயா
thadayangalai	தடையங்களை
thadayanggalai	தடயங்களை
thadayangkalai	தடயங்களை
thadayangal	தடயங்கள்
thadayanggal	தடயங்கள்
thadayangkal	தடயங்கள்
thaduththa	தடுத்த
thaduththana	தடுத்தன
thaduththaar	தடுத்தார்
thadutthaar	தடுத்தார்
thadaigalai	தடைகளை
thadaikalai	தடைகளை
thadaykalay	தடைகளை
thadaigalaith	தடைகளைத்
thadaikalaith	தடைகளைத்
thadaykalayth	தடைகளைத்
thadaipattathu	தடைப்படத்து
thadaiyum	தடையும்
thadaiyai	தடையை
dakshinaamurthy	தென்சாமித்திரி
dhadchanaamoorthi	தட்சந்சூரத்தி
dhadchinamoorthi	தான்சசூந்தி
dhakshinaamoorthy	தாக்சிநாத்திர்
tatchinamurthy	தட்சிசந்திர்
thakshinaamoorththi	தா்கிழாந்தித்தி
thattaan	தாட்டன்
thandanai	தன்னடை
dhandanaigal	தன்டனைகள்
thandanaigal	தன்டனைகள்
thandanaikal	தன்டனைகள்
dhandanaiyilirundhu	தன்டனையிலிருந்து
thandanaiyilirundhu	தன்டனையிலிருந்து
thandanaiyilirunthu	தன்டனையிலிருந்து
thandavaala	தன்டவால்
dhandavaalangal	தட்டவாளங்கள்
thandavaalanggal	தண்டவாளங்கள்
thandavaalangkal	தண்டவாளங்கள்
thandin	தன்தின்
thandhira	தந்திர்
thanthira	நத்திர்
thandhirangalil	தந்திரங்களில்
thanthirangazhil	தந்திரங்களில்
thanthiranggalil	தந்திரங்களில்
thanthirankalil	தந்திரங்களில்
thandhirangal	தந்திரங்கள்
thanthiranggal	தந்திரங்கள்
thanthirankal	தந்திரங்கள்
thandhiraththai	தந்திரத்தை
thanthiraththai	தந்திரத்தை
thanakkaaga	தனக்காக
thanakkaga	தனக்கக
thanithani	தனித்தன்
thaniththani	தனித்தனின்
thanikthanik	தனித்தகனின்
thanithanik	தனிதனித்
thaniththanik	தனித்தனின்
thanithaniyaga	தனிதியனி
thaniththaniyaaga	தனித்தியனாக
thanithaniyaagap	தனினதியாபாக்
thaniththaniyaagap	தனித்தினாயபாக்
thanithaniyana	தனிதியனனன
thaniththaniyaana	தனித்தியனனன
thanithanmaiyana	தனித்தமணையன்
thaniththamaiyaana	தனித்தமையான
thaniththanmaiyaana	தனித்தமண்டையான
thanithanmaiyudan	தனினத்தாமியுடன்
thaniththanmaiyudan	தனித்தன்மையுடன்
thaiththuvamaana	தைத்துமான
thaniththuvamaana	தனித்துமானவ
thanithuvamana	தனித்துமான
thaniththuvamaanadhu	தனித்துமானது
thaniththuvamaanath	தனித்துமானது
thaniththuvamaanathu	தனித்துமானது
thanithuvamanadhu	தனித்துமணவு
thanimangalin	தனிமங்களின்
thanimankalin	தனிமங்களின்
vaayaal	வாயில்
vayal	வியல்
thabasu	தபோசு
thapasu	தபோசு
thamakena	தமாகன்
thamakkaena	தமக்கேன
thamakkena	தமக்கான
tamilagaththilirunthu	தமிழகத்திலிருந்து
tamilagatthilirundhu	தமிழக்கியத்திலுந்து
tamilakatthilirundhu	தமிழக்கத்திலிந்து
tamizhagatthilirundhu	தமிழக்கத்திலுந்து
tamizhakatthilirundhu	தமிழக்கத்திலுந்து
thamilagatthilirundu	தமிழக்கியத்திலுந்து
thamilakatthilirundhu	தமிழக்கியத்திலுந்து
thamizhagatthilirundhu	தமிழக்கத்திலிந்து
thamizhakaththilirundhu	தமிழக்கத்திலிந்து
thamizhakaththilirunthu	தமிழக்கத்திலிந்து
thamizhakatthilirundhu	தமிழக்கத்திலிந்து
tamilagaththilum	தமிழகத்திலும்
tamilagatthilum	தமிழக்த்திலும்
tamilakatthilum	தமிழக்தத்திலும்
tamizhagatthilum	தமிழக்தத்திலும்
tamizhakatthilum	தமிழக்தத்திலும்
thamilagatthilum	தமிழக்தித்துல்
thamilakatthilum	தமிழக்தித்துல்
thamizhagatthilum	தமிழக்தத்திலும்
thamizhakaththilum	தமிழக்தத்திலும்
thamizhakatthilum	தமிழக்தத்திலும்
tamilagaththu	தமிழகத்து
tamilagatthu	தமிழகத்து
tamilakatthu	தமிழகத்து
tamizhagatthu	தமிழகத்து
tamizhakatthu	தமிழகத்து
thamilagatthu	தமிழகத்து
thamilakatthu	தமிழகத்து
thamizhagatthu	தமிழகத்து
thamizhakaththu	தமிழகத்து
thamizhakatthu	தமிழகத்து
tamilagaththukku	தமிழகத்துத்து
tamilagatthukku	தமிழக்கத்துக்கு
tamilakatthukku	தமிழக்கத்துக்கு
tamizhagatthukku	தமிழக்கத்துக்கு
tamizhakatthukku	தமிழக்கத்துக்கு
thamilagatthukku	தமிழக்கத்துக்கு
thamilakatthukku	தமிழக்கத்துக்கு
thamizhagatthukku	தமிழக்தத்துக்கு
thamizhakaththukku	தமிழக்தத்துக்கு
thamizhakatthukku	தமிழக்கத்துக்கு
tamilagaththai	தமிழகத்தை
tamilagatthai	தமிழக்கத்த
tamilakatthai	தமிழக்கத்த
tamizhagatthai	தமிழக்கத்தை
tamizhakatthai	தமிழக்கத்தை
thamilagatthai	தமிழக்கத்த
thamilakatthai	தமிழக்கத்த
thamizhagatthai	தமிழக்தத்தை
thamizhakaththay	தமிழக்கத்த
thamizhakatthai	தமிழக்கத்தை
tamilagaththaich	தமிழக்கத்தத்
tamilagatthaich	தமிழக்கத்தை
tamilakatthaich	தமிழக்கத்தைத்
tamizhagatthaich	தமிழக்கத்தை
tamizhakatthaich	தமிழக்கத்தை
thamilagatthaich	தமிழக்கத்தைத்
thamilakatthaich	தமிழக்கத்தைத்
thamizhagatthaich	தமிழக்கத்தை
thamizhakaththaych	தமிழக்கத்தத்
thamizhakatthaich	தமிழக்கத்தை
tamilagap	தமிழக்்
tamilakap	தமிழக்்
tamizhagap	தமிழக்்
tamizhakap	தமிழக்்
thamilagap	தமிழக்்
thamilakap	தமிழகா்
thamizhagap	தமிழகா்
thamizhakap	தமிழகா்
tamilagam	தமிழகம்
tamilakam	தமிழகம்
tamizhagam	தமிழகம்
tamizhakam	தமிழகம்
thamilagam	தமிழகம்
thamilakam	தமிழகம்
thamizhagam	தமிழகம்
thamizhakam	தமிழகம்
tamilarinar	தமிழிரன்திர்
tamilaringar	தமிழரிங்கர்
thamizharingar	தமிழரிங்கர்
thamizharingyar	தமிழரிக்கின்
tamilaiyum	தமிழையும்
tamizhaiyum	தமிழையும்
thamilaiyum	தமிழையும்
thamillaiyum	தமிழ்யையும்
thamizhaiyum	தமிழையும்
thambadhi	தம்பதி
thambathi	தம்பதி
thampathi	தம்பதி
thambadhigalukku	தம்பதிகளுக்கு
thambathigalukku	தம்பதிகளுக்கு
thampathikalukku	தம்பதிகளுக்கு
thambadhigal	தம்பதித்கள்
thambathigal	தம்பதித்கள்
thambathikal	தம்பதித்கள்
thampathikal	தம்பதிகள்
thambadhikku	தம்பதிக்கு
thambathikku	தம்பதிக்கு
thambadhiyinarukku	தம்பதியினருக்கு
thambathiyinarukku	தம்பதியினருக்கு
thambadhiyinar	தம்பதியினர்
thambathiyinar	தம்பதியினர்
tayaaraanathu	தயாராநது
thayaaraanathu	தயாரானது
thayaranathu	தயராநது
dayalan	டயலன்
dhayalan	யானத்
thayaalan	தயாளன்
thayalan	தயனு்
tharakkoodiya	தரக்கூடிய
tharakkudiya	தரக்குடிய
tharakkuutiya	தரக்குடிய
tharakutiya	தரகுடிய
tharakuutiya	தரகுடிய
tarataik	தறையக்
tharathaik	தரத்தைக்
tharaththaik	தரத்தைக்
tharatthai	தரத்தை
tharavarisaip	தரவரசிப்
tharavarisaiyil	தரவர்சையில்
tharavillai	தரவில்லை
tharavugalai	தரவுகளை
tharavukalai	தரவுகளை
tharavugalaith	தரவுகளைத்
tharavai	தரவை
tharuginraar	தருகின்றார்
tharukinraar	தருகின்றார்
tharukintraar	தருகின்றார்
tarunankalil	தருணங்களில்
tharunangalil	தருஙங்களில்
tharunankalil	தருணங்களில்
tharunankkalil	தருஙங்களில்
tarunatthai	தருநடத்தை
tharunathai	தருநதை
tharunaththai	தருநத்தை
tharunatthai	தருநடத்தை
tarunamaka	தருமணக
tharunamaaga	தருமானக
tharunamaaka	தருமானக
tharunamaka	தருமணக
dharmapuri	தரம்பூரி
thalainagaram	தலைநகரம்
thalaynagaram	தலைநகரம்
thalaynakaram	தலைநகரம்
thalaimaiyidamaaga	தலைமையிடமாக
thalaimaiyidamaaka	தலைமையிடமாக
thalaimaiyidam	தலைமையிடம்
thalaimaiyaetroor	தலையமறையூர்
thalaimaiyaettraar	தலையையுந்தார்
thalaimaiyetraar	தலையையுர்தார்
talaivanukku	தலைவனுக்கு
thalaivanukku	தலைவனுக்கு
talaivanum	தலைவனும்
thalaivanum	தலைவனும்
talaivanai	தலைவனை
thalaivanai	தலைவனை
talaivarai	தலைவரை
thalaivarai	தலைவரை
thala	நததியாம்
thalaththudan	தளத்துடன்
thalatthudan	தளத்துடன்
thalamaaga	தலமாக
thalamaaka	தலமாக
thalamaanadhu	தலமானது
thalamaanathu	தலமானது
thalamum	தமுளம்
thalavaada	தவாாட
thalavaata	தவலாட
thalavaadangal	தலவாடங்கள்
thalavaadangkal	தலவாடங்கள்
thalavaadankal	தலவாடங்கள்
thalavaatankal	தலவாடங்கள்
vittathu	விற்டுத்
vittatu	விற்டு
poadum	புடும்
podum	புடும்
potum	புடும்
thavikkum	தவிக்கும்
thavil	தவில்
mudiyavillai	முடியவில்லை
mutiyavillai	முட்யியவவில்லை
thaangak	தாங்கு
thaangkak	தாங்கு
thaankak	தன்க்க
thaangakkoodiya	தாங்ககூட்டிய
thaangakkuudiya	தாங்கக்கூடிய
thaangkakoodiya	தாங்கூகூடிய
thaankakkoodiya	தாங்கக்கூடிய
thaankakkuudiya	தாங்கக்கூடிய
thangakudiya	தங்ககுடிய
thaangal	தாங்கள்
thaangkal	தாங்கள்
thaankal	தாங்கள்
thaangaamal	தாங்காமல்
thaangkaamal	தாங்காமல்
thaankaamal	தான்காலம்
dasan	டசன்
dhaasan	சுரன்
thaasan	தனசன்
manal	மனன்
thaadhu	தனது
thaathu	துது
thaadhup	தாயுப்
thaathup	துத்துப்
thaamiram	தாமிரம்
thamiram	தமிரம்
thaamboolam	தாம்போலம்
thambulam	தம்புளம்
thaayagamaana	தாயகமான
daara	நாதிரா
dara	டரியா
taara	நாதிரா
tara	நாதிரா
taraa	நாதியா
tarra	டறியா
thaaraa	தரை
thara	நதிரா
thaaraavin	தாரவின்
tharavin	தரவின்
taliban	திிப்பான்
talibangal	தலிபங்கள்
thittamida	திட்டமிட்ட
thittamidal	திட்டமிட்டல்
thittamidum	திட்டமிடும்
dmk	டிமுக்
thimuka	திமுக்கா
dmkvin	திம்விங்
thimukavin	திமுகாவின்
thiyaagaraaja	தியாகராஜ
thiyaakaraaja	தியாகராஜ
thyaagaraja	தாயகராஜ்
thiyaakaraajan	தியாகராஜன்
thiyagarajan	தியகரான்
thyaagarajan	தியாகரான்
thiyaagaraajar	தியாகராாசர்
thiyaakaraajar	தியாகராசர்
thiyakarajar	தியகராசர்
tiyaakaraajar	தியாகராசர்
thiruchchiraappalli	திருச்சாப்பிரளில்
tiruchchirappalli	திருச்சியப்பாலில்
thiruchchiraappalliyil	திருச்சாப்பியலிலில்லை
tiruchchirappalliyil	திருச்சிபப்பிலிலைல்
thirumangai	திருமணைக்
thirumangkai	திருமங்கை
thirumangaiyaalvaar	திருமங்கையாவர்்
thirumangaiyaazhvaar	திருமங்கையாவர்்
thirumangkaiyazhvar	திருமைஞ்காவத்தி
thirumaalin	திருமாலின்
thirumalin	திருமலின்
thirumulukku	திருமுழிக்கு
thirumuluku	திருமுழுக்கு
tirumulukku	திருமுழிக்கு
thiruvarangam	திருவனரக்கம்
thiruvarangkam	திருவனரங்கம்
thiruvarankam	திருவரங்கம்
tiruvarankam	திருவரங்கம்
thiruvaadaanai	திருவானாடை
thiruvadanai	திருவணடை
thiraikku	திரைக்கு
thiraiku	திரைக்
tiraikku	திரைக்கு
thiraikkup	திரைக்குப்
thiraikup	திரைக்குப்
tiraikkup	திரைக்குப்
thiraith	திரைத்
tiraith	திரைத்
thiraiyin	திரையின்
thirayin	திரையின்
tiraiyin	திரையின்
thira	திரா
tira	டிரா
thiranum	திரனும்
mikka	மிக்கா
thiran	திரன்
thiranankalaiyum	திரனங்களையும்
thirangalaiyum	திரங்களையும்
thirankalaiyum	திறங்களையும்
thirangal	திறங்கள்
thirankal	திறங்கள்
theettappatta	தேட்டப்பட்ட
theettappattullathu	தேட்டப்பட்டுள்ளது
theendaamai	தீன்டமை
dheeni	ினை
theeni	தினை
deepak	ீதபு
deepaq	ீதப்
dheepak	தீபாக்
diipak	டிபாக்
theepak	தீப்
tiipak	திபாக்
deebanggal	தீபங்கள்
deepanggal	தீபங்கள்
deepankal	தீபங்கள்
theepangal	தீபங்கள்
theepangkal	தீபங்கள்
deepan	ிியப்
dheepan	திபன்
theepan	தினப்
dheergadarisi	தீரக்கரித்
theerkkatharisi	தீர்க்கத்திி
theerppaayam	தீர்ப்பாய்
theerppaal	தீர்ப்பால்
theerppin	திர்ப்பின்
theermaaniththanar	தீர்மானித்தார்
thuduppu	துடுப்பு
thudaippam	துடைப்பம்
thunindhu	துனின்து
thuninthu	துனின்து
thunburuthal	துன்புருதல்
thunburuththal	துன்புருத்தல்
thunpuruththal	துன்புறுத்தல்
thuruvak	துருவக்
thuruvam	துருவம்
dhroanar	துரான்
dronar	டிரோன்
thuronar	துரண்்
dhurkkai	துர்க்கை
durgai	துரைக்
durkkai	துர்க்கை
thuravi	துரவி
thuravigalin	துரவிகளின்
thuravikalin	துரவிகளின்
thuraigal	துறைகள்
thuravigal	துரவிகள்
thuravikal	துரவிகள்
thuraviyin	துரவியின்
thuraiviyum	துறைவியும்
thuraviyum	துரவியும்
thuraikkum	துறைக்கும்
thulai	துரை
thilaigalai	திலைகளை
thulaigalai	துலைகளை
thulaikalai	துலைகளை
thulaigal	துலைகள்
thulaikal	துலைகள்
thulaiththu	துழைத்து
thulaithu	துழைத்து
thulaiyin	துழையின்
thulaiyil	துழையில்
thulaiyai	துழையை
thuvakathil	துவகத்தில்
thuvakkaththil	துவக்கத்தில்
thuvakkappattu	துவக்கப்பட்டு
thuvakamaga	துவகமாக
thuvakkamaaga	துவக்கமாக
thuvakkamaaka	துவக்கமாக
thuvakkam	துவக்கம்
thuvangapata	துவங்கப்பட்ட
thuvangappatta	துவங்கப்பட்ட
thuvanggappatta	துவங்கப்பட்ட
thuvangkappatta	துவங்கப்பட்ட
thuvangavillai	துவங்கவில்லை
thuvanggavillai	துவங்கவில்லை
thuvangkavillai	துவங்கவில்லை
thoodhu	தூது
thoothu	தூது
doordarshan	டுரர்சா்
doordharshan	துரர்சத்
thoortharshan	தூர்தரசன்
thoolaith	தூழைத்
thuulaith	துழைத்
therigiradhu	திரிகிறது
therigirathu	திரிகிறது
therkaaga	தேர்காக
therkaaka	தேர்காக
therkkaaka	தேர்காக
therkilirunthu	தேற்கிலிருந்து
therkkilirundhu	தீர்கிலின்துந்
thaekka	தேக்க
thekka	தேக்கு
thaengaip	தேங்கைப்
thaenkaaip	தேங்காய்
thengaip	தென்கைப்
thaer	தியூர்
ther	தியூர்
thaerndhedukkum	தேர்ந்தெடுக்கும்
thaernthedukkum	தேர்ந்தெடுக்கும்
thernthedukkum	தேர்ந்தெடுக்கும்
thaervin	திர்வின்
thervin	திர்வின்
thaervil	தேர்வில்
thervil	திர்வில்
thaervai	தேர்வை
thervai	திரவை
devalaya	தேவாய
thevaalaya	தேவாலய
devaalayam	தேவாலயம்
devalayam	தேவலயம்
thevaalayam	தேவாலயம்
deviyar	டிவியர்
theviyar	தியவியர்
thoguththa	தொழுத்த
thoguththaar	தொகுத்தார்
thoguppin	தொகுப்பின்
thokupin	துக்குப்
thokuppin	தொகுப்பின்
thoguppilum	தொகுப்பிலும்
thokupilum	தொகுப்பிலும்
thokuppilum	தொகுப்பிலும்
thoguppil	தொகுப்பில்
thokupil	தொகுப்பில்
thokuppil	தொகுப்பில்
thoguppaiyum	தொகுப்பையும்
thokupaiyum	தொகுப்பையும்
thokuppaiyum	தொகுப்பையும்
thogaigal	தொகைகள்
thokaikal	தோக்களை
tokaikal	தொக்கைகள்
thogaikku	தோக்கைக்
thokaikku	தோக்கைக்
thokaiku	தோக்கைகு
thogaiyaanthu	தோகையான்து
thokaiyaanathu	தோக்காயந்து
thokaiyanathu	தோக்கையந்து
thogaiyin	தாகையின்
thokaiyin	தாக்கையின்
tokaiyin	துகையின்
thogaiyee	தாகுடை
thokaiye	தாக்கே
thokaiyee	தாக்கேயே
thogaiyai	தோகையை
thokaiyai	தோக்கையை
tokaiyai	தாக்கையை
thokaiyaik	தோகையைக்
tokaiyaik	தோகையைக்
thoda	நோத்து
thota	நததோ
thodaraana	தொரடான
thodarukku	தொடருக்கு
thodarbukalil	தொடர்புகளில்
thodarpukalil	தொடர்புகளில்
thotarpukalil	தொடர்புகளில்
totarpukalil	தொடர்புகளில்
thodarbukalum	தொடர்புகளும்
thodarpukalum	தொடர்புகளும்
thotarpukalum	தொடர்புகளும்
totarpukalum	தொடர்புகளும்
thodarbugalaiyum	தொடர்புகளையும்
thodarbukalaiyum	தொடர்புகளையும்
thodarpukalaiyum	தொடர்புகளையும்
thodarbugal	தொடர்புகள்
thodarbukal	தொடர்புகள்
thodarpukal	தொடர்புகள்
thodarbukku	தொடர்புக்கு
thodarpukku	தொடர்புக்கு
thodarbudan	தொடர்புடன்
thodarpudan	தொடர்புடன்
thodarbuth	தொடர்ப்து
thodarputh	தொடர்ப்து
thodumpoothu	தொடும்போது
thodumpothu	தொடும்போது
thotumpothu	தொடும்போது
thottu	தொடு
thotu	தோயு
tholainokki	தொலைந்துக்
tholainookki	தொலைந்கூசி
tholainokkiyai	தொலைந்கோக்கை
tholainookkiyai	தொலோலியுகியை
tholaipaesi	தொலைப்சி
tholaipesi	தாலைப்சி
tholaipaesialil	தொலைப்பேயில்ல்
tholaipesigalil	தொலைப்பியலிகளில்
tholaipesikalil	தொலைப்பியலிகளில்
tholilin	தொழிலின்
thozhilin	தொழிலின்
tholilil	தொழிலில்
thozhilil	தொழில்லில்
tholuthaar	தொழுத்தார்
thozhuthaar	தொழுத்தார்
tholumpoathu	தொழும்போது
thozhumpoathu	தொழும்போது
thozhumpoothu	தொழும்போது
thozhumpothu	தொழும்போது
thoandum	தன்டும்
thondum	தன்டும்
thoontum	தன்தும்
thondriya	தன்றிய
thontriya	தன்றிய
thoontriya	தூன்றிய
thondriyadhaal	தொன்றியாால்
thondriyathaal	தொன்றியாால்
thontriyathal	தொன்றியதால்
thoontriyathaal	தூன்றியதால்
thondriyulladhu	தொன்றியுள்ளது
thondriyullathu	தொன்றியுள்ளது
thontriyulathu	தொன்றியுள்ளது
thoontriyullathu	தூன்றியுள்ளது
thoamas	தூரம்
thomas	தூசு
dhoranai	தோரணை
thoaranai	தோரணை
thoarruvikka	தோருவிக்க
thoatruvikka	தோற்றுவிக்க
thoattruvikka	தோற்றுவிக்க
thoarruviththavar	தொறுவிறத்தார்
thoatruviththavar	தொற்றுவித்தார்
thoattruviththavar	தோற்றுவித்தார்
thoarruviththaar	தொறுவிற்தார்
thoatruviththaar	தொற்றுவித்தார்
thoattruviththaar	தோற்றுவித்தார்
thoarruviththu	தூற்றுவித்து
thoatruviththu	தோற்றுவித்து
thoattruviththu	தோற்றுவித்து
thoalvikku	தோழ்விக்கு
tholvikku	தொழிவுக்கு
tholviku	தொழிவுக்
thoolvikku	தூழ்விக்கு
thoalvikkup	தோழ்விக்குச்
tholvikkup	தொழிவ்குக்
tholvikup	தொழிவ்குப்
thoolvikkup	தூழ்விக்குச்
thoalviyil	தோழ்வியில்
thoalviyae	தோவிலையே
thoalviyaith	தோழ்வியைத்
nagaraththaich	நகரத்திச்
nadakkiradhu	நடக்கிறது
nadakkirathu	நடக்கிறது
nadaiperaadha	நடைபெறாத
nadaiperaatha	நடைபெறாத
nadiperaadha	நடிபிராத
nadaiperaamal	நடைப்பேறால்
nadaiperuvadhai	நடைபெறுவதே
nadaiperuvathai	நடைபெறுவதே
moolaam	முலாம்
moolam	முள்
mulam	முளம்
nadhigalum	நதிகளும்
nadhigazhum	நதிகளும்
nadhikalum	நதிகளும்
nathigalum	நதிகளும்
nathikalum	நதிகளும்
nadhik	நாதிக்
nathik	நாதிக்
nadhiyaana	நதியான
nathiyaana	நதியான
nadhiyilirunththu	நதியிலிருந்து
nadhiyilirunthu	நதியிலிருந்து
nathiyilirunthu	நதியிலிருந்து
nadhiyil	நதியில்
nathiyil	நதியில்
nadhiyaiyum	நதியையும்
nadiyaiyum	நடியையும்
nathiyaiyum	நதியையும்
naththam	நத்தம்
nanmai	நம்மை
nannanmy	நணன்மணி
nanmaigalai	நண்மைகளை
nanmaigazhai	நண்மைகளை
nanmaikalai	நண்மைகளை
nanmaigalaip	நண்மைகளைப்
nanmaigazhaip	நண்மைகளைச்
nanmaikalaip	நண்மைகளைப்
nanmaigal	நண்மைகள்
nanmaikal	நண்மைகள்
nanmaikaka	நண்மைக்க
nanmaikkaaga	நண்மைக்காக
nanmaikkaaka	நண்மைக்காக
nanmaiyaaga	நண்மையாக
nanmaiyaaka	நண்மையாக
nanmaiyaka	நண்மையாக
nanmaiyae	நம்னையே
nanmaiyaiye	நம்னையை
nanmaiyaiyee	நம்றையையே
nanmaiye	நம்னையே
nayathodu	நாயதூது
nayathotu	நயதோது
nayaththoadu	நயத்தோடு
nayaththodu	நயத்தோது
nayatthootu	நயத்தூட்
nayam	நையம்
narachiman	நரசிசம்
narachimman	நாரச்சமமின்
narasimman	நாரசமமின்
narambugalai	நரம்புகளை
narambukalai	நரம்புகளை
narampukalai	நரம்புகளை
narambugal	நரம்புகள்
narambukal	நரம்புகள்
narampukal	நரம்புகள்
narpanbugal	நற்ப்பூணக்கள்
narpanbugazh	நர்ப்புக்கள்
narpanbukal	நற்புப்பால்
narpanpukal	நற்புப்பாகள்
nala	நோத்
nalla	நாத்தில்
vali	வில்
vazhi	வுழி
nallaar	நால்லார்
nalloar	நலைஸ்
nalloor	நலூர்
nalor	நோலர்
nalan	நானு
naliravu	நலிரவு
nalliravu	நல்லிரவு
nav	னுப்
nava	நோவீ
naw	ணியு
nawa	நோவா
noa	நோ
nov	னு
now	னு
navachakthi	நவசக்தி
navasakthi	நவசக்தி
navashakthi	நவச்சத்தி
navami	நவமு
navam	நவம்
naveenath	நவீனத்
naveenaththuva	நவேநதத்துவ
naveenaththuvam	நவேநத்துவும்
naveenam	நவீனம்
naveen	னவியும்
naviin	நிவுண்
navin	ணவின்
naween	னுவேன்
nawiin	நியுஷ்
nawin	ணவின்
naagareegangalil	நாகரேக்களின்
naagareegangazhil	நாகரேக்களில்
naagareeganggalil	நாகரேக்கங்களில்
naagareegaththai	நாகேகத்திய
naasaavin	நாசாவின்
nasavin	நசவவின்
naasaavil	நாசாவில்
nasavil	நசுவலி்
naasi	நோசி
nasar	நசர்
nasr	நார்ஸ்
nasra	நாத்ர்
naanchil	நான்சில்
nanchil	நன்சில்
nanjil	நஞ்சில்
naadukadaththa	நாடுகத்தத்
naadukadattha	நாடுகத்தாத
naadukadaththappatta	நாடுகடுத்தப்பட்ட
naadukadatthappatta	நாடுகடுத்தப்பட்ட
naadoadi	நோடாதி
naadodi	நாடுடி
naadoodi	நாடுடி
naattavargal	நாட்டவர்கள்
naattavargazh	நாட்டவரங்கள்
naattiya	நாத்திய
naattiyaththil	நாட்டியத்தில்
naattiyap	நாட்டியப்
naana	நோயா
naanaa	நாயு
nana	நோய்
nanaa	நநீ
naanooru	நூருவு
naaraayanaaya	நாராயணாய்
narayanaya	நரயானாய்
naarpathu	நார்பது
naarpathukkum	நார்பதுக்கும்
naatraththai	நாற்றத்தை
naattraththai	நாற்றத்தை
nigara	நிகரா
nikara	நிகர்
nigalthagavu	நிகழ்தாகு
nigazhthagavu	நிகழ்தாகு
nikazhthakavu	நிகழ்தாகவு
nigalththa	நிகழ்த்த
nigazhththa	நிகழ்த்த
nikazhththa	நிகழ்த்த
nigalththappadum	நிகழ்த்தப்படும்
nigazhththappadum	நிகழ்த்தப்படும்
nikazhththappadum	நிகழ்த்துப்படும்
nigalvugalaal	நிகழுவ்களால்
nigalvugazhaal	நிகழுவ்களால்
nigazhvugalaal	நிகழ்வுகளால்
nikazhvukalaal	நிகழ்வுகளால்
nigalvugalin	நிகழுவ்களின்
nigalvugazhin	நிகழுவ்களின்
nigazhvugalin	நிகழுவ்களின்
nikazhvukalin	நிகழ்வுகளின்
nigalvugalaip	நிகழுவ்களைப்
nigalvugazhaip	நிகுவல்களைப்
nigazhvugalaip	நிகழுவ்களைப்
nikazhvukalaip	நிகழ்வுகளைப்
nigalvugalaiyum	நிகுவலைகளையும்
nigalvugazhaiyum	நிகுவல்களையும்
nigazhvugalaiyum	நிகழ்வுகளையும்
nikazhvukalaiyum	நிகழ்வுகளையும்
nigalvum	நிகழுவும்
nigazhvum	நிகழுவ்ம்
nikazhvum	நிகழ்வும்
nigalvai	நிகழ்வை
nigazhvai	நிகழ்வை
nikazhvai	நிகழ்வை
nigalvaip	நிகழ்வைப்
nigazhvai	நிகழ்வை
nigazhvaip	நிகழ்வைப்
nikazhvaip	நிகழ்வைச்
nigalvaiyum	நிகழ்வையும்
nigazhvaiyum	நிகழ்வையும்
nikazhvaiyum	நிகழ்வையும்
nicotin	நிகோட்டின்
nicotine	நிகோடியின்
nikoatin	நிகோட்டின்
nesan	நிசன்
nessan	நிசன்
nisaan	நிசான்
nisan	ினசன்
nissan	ிிசன்்
nissann	ிிசனன்
ninaivaagavum	நினைவாகவும்
ninaivaakavum	நினைவாகவும்
niyamanam	நியமானம்
niyamika	நியமிக்க
niyamikka	நியமிக்க
nirubar	நிறுப்
nirupar	நிறுப்
nirvagikka	நிற்வகக்க்
nirvakikka	நிற்வகக்க்
nirvagikkum	நிற்வகிக்கும்
nirvakikkum	நிற்வககிக்கும்
nirvaaga	நிற்வாகு
nirvaaka	நிற்வாகு
nirvaagak	நிர்வாகக்
nirvaagangal	நிர்வாகங்கள்
nirvaaganggal	நிர்வாகங்கள்
nirvaagath	நிர்வாதது
nirvaagaththirkum	நிர்வாதிக்கத்து
nirvaagaththilum	நிர்வாத்திலுுு
nirvaakaththilum	நிர்வாத்திலுுு
nirvaagaththil	நிர்வாத்தித்தில்
nirvaagamum	நிர்வாகமும்
nirvaakamum	நிர்வாகமும்
nirvakamum	நிர்வகமும்
niraivurum	நிறைவுரும்
nilak	நிலக்
nilakkadalai	நிலக்கத்தை
nilainiruththa	நிலையிருந்த
nilainiruththik	நிலைநிருத்திற்
nilainiruththum	நிலையிருந்ததும்
nee	னீ
nii	னிய்
neettik	நீட்டு
neettippu	நீத்துப்பு
neethaan	நிதான்
neethu	நூது
neetu	நியு
neeyae	நியே
neeyea	நியே
neeraetram	நீரத்தும்
neeraetrtram	நீறேற்றதும்
neereatram	நீராட்டும்
neerai	நீரை
neeraith	நீரைத்
neeraip	நீரைப்
neeraiyum	நீரையும்
naro	நோரு
nearo	நோரு
neero	நோரு
neeroa	நோரே
neeroo	நோரு
nero	நோரு
neroo	நோரு
niiro	நோரி
niiroo	நைரோ
niro	நோரு
niroo	நோரீத்
neeroadu	நீரோடு
neeroattanggal	நீரோட்டங்கள்
neeroattangkal	நீரோட்டங்கள்
neeroattankal	நீரோட்டங்கள்
neeroattaththin	நீராட்டத்தின்
neeroattaththil	நீரோட்டத்தில்
neeroattam	நீரோட்டம்
neerroattam	நீர்ட்டு்
neermattam	நீர்மத்தம்
neervala	நீர்வால்
neervalam	நீர்வலம்
nun	னுன்
nunmai	நுமை
nuraiyeeralin	நுறையெரலின்
nuraiyiiralin	நுறையிலரின்
nuraiyeeralil	நுறையேலில்
nuraiyiiralil	நுறையிலரில்
nuraiyeeral	நுறையேல்
nuraiyiiral	நுறையில்
nulainththa	நுழைந்து
nuzhaindha	நுழைந்த
nuzhinththa	நுழிந்து
nulainthathaal	நுழைந்ததால்
nuzhaindhadhaal	நுழைந்ததால்
nuzhinththathaal	நுழிந்ததால்
nulainthathu	நுழைந்தது
nuzhaindhadhu	நுழைந்தது
nuzhinththathu	நுழிந்தது
nulainththathum	நுழைந்ததும்
nuzhaindhadhum	நுழைந்ததும்
nuzhinththathum	நுழிந்ததும்
nulainthana	நுழைந்தன
nuzhaindhana	நுழைந்தன
nuzhinththana	நுழிந்தன
nulainththanar	நுழைந்தனர்
nuzhaindhanar	நுழைந்தனர்
nuzhinththanar	நுழிந்தனர்
nulainthapoathu	நுழைந்தபோது
nuzhaindhapoadhu	நுழைந்தபோது
nuzhinththapoathu	நுழிந்தபோது
nulainththaar	நுழைந்தார்
nuzhaindhaar	நுழைந்தார்
nuzhinththaar	நுழிந்தார்
nootriyettu	நூற்றியெட்டு
nootrtriyettu	நூற்றியெட்டு
noottriyettu	நூற்றியெட்டு
noolaga	நூலா்
noolaka	நூலா்
noolagangalil	நூலக்களில்
noolagangkalil	நூலக்களில்
noolakangalil	நூலக்களில்
noolakangkalil	நூலக்களில்
noolagangal	நூலக்கள்
noolagangkal	நூலக்கள்கள்
noolakangal	நூலக்கள்
noolakangkal	நூலக்கள்கள்
noolagath	நூலகத்
noolakath	நூலகத்
noolagaththirku	நூலகத்திற்கு
noolakaththirkku	நூலகத்திற்கு
noolakaththirku	நூலகத்திற்கு
noolagaththil	நூலகத்தில்
noolakaththil	நூலகத்தில்
noolagaththai	நூலகத்தை
noolakaththai	நூலகத்ததி
noolagamum	நூலகமும்
noolakamum	நூலகமும்
noolum	நுசும்
noolae	நூரை
noole	நூரை
neduncheralathan	நெடுஞ்செலர்நாத்
nedunjchaeralaathan	நெடுஞ்செயலாந்தார்
nedunjeralaadhan	நெடுஞர்செலந்தார்
nedunjeralaathan	நெடுஞர்செலந்தார்
nerippaduththum	நெறிப்படுத்தும்
nerri	நிரு
netri	நிற்றி
nettri	நிற்றி
netrip	நிறுப்
nettrip	நிற்றுப்
nelsan	நிலஸ்்
nelson	நிலஸ்்
naeyargal	நேயர்கள்
neyargal	நியர்கள்
neyarkal	நியர்கள்
neerittathu	நீரித்துடு
neritathu	நேரித்தது
nerittadhu	நேரித்தது
nerittathu	நேரித்தது
neerittaal	நீரிட்டால்
nerital	நிறுதல்
nerittaal	நேறிட்டால்
naooyda	நூயாத்
noida	நோய்ட
noidaa	நோய்ட
noyda	நோய்ட
noyta	நோய்ட
noytaa	நோய்ட
noakki	நோக்கி
nokki	னுக்கி
noakkith	நோக்கித்
nokip	னிக்குப்
nokkip	நோக்கிப்
nookkip	நூக்கிப்
nokiye	நோக்கேய்
nokkiye	நோக்கேயி
nookkiyee	நூக்கேயே
nokil	நோக்கில்
nokkil	நோக்கில்
nookkil	நூக்கில்
nooyinai	நோயினை
noyinai	நோயினை
noaiththotru	நோய்ட்றுத்து
noayththotru	நோய்ற்றோது
noiththottru	நோய்ற்றுத்து
pagadai	பாடகு
pakadai	பாடகு
baka	நாப்பு
bakaa	பாக்கா
bhaga	போராஜ்
pakaa	பாாகு
bhageerathan	பேகரத்தான்
pakeerathan	பகீரத்தன்
pakiirathan	பகிரத்தன்
pakirathan	பகிரத்தன்
paguthiyaith	பகுதியைத்
pakuthiyaith	பகுதியைத்
paguppaaivu	பகுபாவிப்
paguppaayvu	பகுவாப்பு
pakuppaaivu	பகுபாவ்போ
pangkuthaarar	பங்குதார்
panguthaarar	பங்குதார்
pankuthaarar	பங்குதார்
pankutharar	பண்குத்தார்
panguthaarargalaaga	பங்குதரர்காாக
panguthaararkalaaka	பங்குதரர்களாக
panguthararkalaka	பங்குரத்தாகக
pankuthaararkalaaka	பங்குதர்தாககால்
bangkuthaararkalin	பங்குதாரர்களின்
panguthaarargalin	பங்குதரர்களின்
pankuthaararkalin	பங்குதரர்களின்
pankuthararkalin	பங்குரத்தினரில்
bangkuthaararkal	பங்குதாரர்கள்
panguthaarargal	பங்குதாரர்கள்
pankuthaararkal	பங்குதார்களர்
pankuthararkal	பண்குதர்களர்
pasukkalin	பசுக்களின்
pasukkazhin	பசுக்கழின்
pasukkalil	பசுக்களில்
pasukkazhil	பசுக்களில்
pasukkal	பசுக்கள்
padangalin	படங்களின்
padangkalin	படங்களின்
pandangalin	பண்டங்களின்
padangalilum	படங்களிலும்
padangkalilum	படங்களிலும்
pandangalilum	பண்டங்களிலும்
padangalukkum	படங்களுக்கும்
padanggalukkum	படங்களுக்கும்
padangaludan	படங்களுடன்
padanggaludan	படங்களுடன்
padappidippu	படட்பிபிப்பு
padappidippugal	படட்பிடிப்புகள்
padappidippukal	படட்பிடிப்புகள்
padarndhu	படர்ந்து
padarnththu	படர்ந்து
padarnthu	படர்ந்து
padala	படலு
padalangal	படலங்கள்
padalankal	படலங்கள்
padalaththil	படலத்தில்
padigalin	படிகளின்
padikalin	படிகளின்
padigal	படிகள்
padikal	படிகள்
padikku	படிக்கு
poluthu	பொழுது
polutu	பொழுது
pozhuthu	பொழுத்து
padidhal	படித்தல்
padithal	படித்தல்
padinilai	படினிலை
padinilaigalil	படிநிலைகளில்
padinilaikalil	படினிலைகளில்
padipai	படிப்பை
padippai	படிப்பை
patippai	படிப்பை
padipaith	படியப்ப்
padippaith	படிப்பைத்
patippaith	படிப்பைத்
padipaiyum	படியைப்பு
padippaiyum	படிப்பையும்
patippaiyum	படிப்பையும்
padimangalai	படிமங்களை
padimangazhai	படிமன்களை
padimankalai	படிமன்களை
patimankalai	படிம்்களை
padimathin	படிமதிதின்
padimaththin	படிமத்தின்
padimatthin	படிமடிதின்
patimatthin	படிமத்தின்
padimam	படிமம்
patimam	படிமம்
padiyil	படியில்
patiyil	பெடியில்
paduthiya	வடுத்திய
paduththiya	நடுத்திய
padutthiya	வடுத்திய
patuthiya	படுதிய
paduthiyathu	படுதியது
paduththiyadhu	படுத்தியது
paduththiyathu	படுத்தியது
padutthiyathu	படுத்தியது
patutthiyathu	படுத்தியது
paduththiyulladhu	படுத்தியுள்ளது
paduththiyullathu	படுத்தியுள்ளது
padaithathu	படைத்து
padaiththathu	படைத்தது
padaitthathu	படைத்தது
pataitthathu	படைத்தது
padaithanar	படைத்தனர்
padaiththanar	படைத்தனர்
padaitthanar	படைத்தனர்
pataitthanar	படைத்தனர்
padaithalapathi	படைதளத்தி
padaiththalapathi	படைத்தளப்பத்
padaitthalapathi	படைத்தளப்பட்
pataitthalapathi	படைத்தள்்பத்
padaithan	படைத்தன்
padaiththaan	படைத்தான்
padaitthaan	படைத்தான்
pataitthaan	படைத்தான்
padaiththu	படைத்து
padaithu	படைது
padaitthu	படைத்து
pataitthu	படைத்து
padaipaka	படைப்பாக
padaippaakka	படைப்பாக்க
padaippakka	படைப்பகக்
pataippaakka	படைப்பாக்க
padaiyinarum	படையினரும்
pataiyinarum	படையினரும்
pattathu	பட்டது
panayak	பணயாக்
panigalin	பணிகளின்
panigazhin	பணிகளின்
panigalukku	பணிகளுக்கு
panigazhukku	பணிகளுக்கு
panigalukkup	பணிகளுக்குப்
panigazhukkup	பணிகளுக்குப்
panigalukkum	பணிகளுக்கும்
panigazhukkum	பணிகளுக்கும்
panigalum	பணிகளும்
panigazhum	பணிகளும்
panigalai	பணிகளை
panigazhai	பணிகளை
panigalaip	பணிகளைப்
panigazhaip	பணிகளைப்
panigalaiyum	பணிகளையும்
panigazhaiyum	பணிகளையும்
panigal	பணிகள்
panigazh	பணிகள்
panikkaana	பணிக்கான
panithan	பனிதன்
paniththaan	பனித்தான்
panitthaan	பனித்தான்
panimanai	பணிமணை
paniyaanadhu	பணியானது
paniyaanathu	பணியானது
paniyin	பினியின்
paniyilirindhu	பணியிலிருந்து
paniyilirunthu	பணியிலிருந்து
paniyilum	பணியிலும்
paniyum	பணியும்
panpaadu	பன்பாடு
panbaadugalin	பண்பாடுகளின்
panpaadugalin	பன்பாடுகளின்
panpaadugazhin	பண்பாடுகளின்
panpaadukalin	பண்பாடுகளின்
panbaadum	பன்பாடும்
panpaadum	பன்பாடும்
padhikkappatta	பதிக்கப்பட்ட
pathikkappatta	பதிக்கப்பட்ட
padhinaezhyaam	பதினேழியம்
pathinaelaam	பதினேலாம்
pathinaezhaam	பதினேழம்
pathinealaam	பதினாலமம்
pathineazhaam	பதினேழாம்
pathinezhaam	பதினேழம்
padhinoaraavadhu	பதினோராவது
pathinaoraavathu	பதிநோராவது
pathinoaraavathu	பதினோராவது
padhippiththa	பதிப்பித்த
pathippiththa	பதிப்பித்த
pathippittha	பதிப்பிட்த
padhippiththullaar	பதிப்பிடுத்தாள்
pathippiththullaar	பதிப்பிதுத்துள்ள
pathippitthullaar	பதிப்பிடுத்தாள்
padhulaiyil	பதுளையில்
pathulaiyil	பதுளையில்
paththaandu	பத்தான்டு
paththaandugalaaga	பத்தாண்டுகளாக
paththaandukalaaka	பத்தாண்டுகளாக
paththaandugalil	பத்தான்டுகளில்
paththaandukalil	பத்தான்டுகளில்
paththaandugal	பத்தான்டுகள்
paththaandukal	பத்தான்டுகள்
padmanaaban	பட்டமானன்
pathmanaaban	பத்தமானன்
pandhiyil	பந்தியில்
panthiyil	பந்தியில்
panththiyil	பந்தியில்
panimalai	பணிமலை
pannirandaam	பண்னிரண்டம்
pannirendaam	பண்ணிராந்தம்
pannirendu	பண்னிருந்து
pandri	ணிற்றி
panri	னிப்பி
pandrikalin	பண்டிரிகளின்
panrigalin	பண்றிகளின்
panrikalin	பண்றிகளின்
pandrikalai	பண்டிரளை
panrigalai	பண்றிகளை
panrikalai	பண்றிகளை
pandrikal	பண்டிருகள்
panrigal	பண்றிகள்
panrikal	பண்றிகள்
pandriyin	பண்றியின்
panriyin	பண்றியின்
bambaram	பம்பரம்
pambaram	பம்பரம்
pamparam	பம்பரம்
cet	னிய்
pamp	பிமம்
pump	பும்
puump	பும்
set	ன்சு
payanamaanaar	பயனமானர்
payaniththu	பயனித்து
payanithu	பயனிது
payanpaduththavillai	பயன்படுத்தவில்லை
payanpaduththuvathai	பயன்படுத்துவதை
payanpaduthuvathai	பயன்படுத்துவதை
payanpatuththuvathai	பயன்படுத்துவதை
payir	பியர்
payirgalin	பயிர்களின்
payirkalin	பயிர்களின்
payirgalil	பயிற்களில்
payirkalil	பயிற்களில்
payirgalukku	பயிர்களுக்கு
payirkalukku	பயிர்களுக்கு
payirgalum	பயிர்களும்
payirkalum	பயிர்களும்
paiyrkalaith	பய்்
payirgalaith	பயிர்களைத்
payirkalaith	பயிர்களைத்
paiyrch	பயிற்ச்
payirch	பயிர்ச்
baiylvaan	பிய்வாலன்
bayilvaan	பியல்வான்
paiylvaan	பிய்வாலன்
payilvaan	பியல்வான்
barathaechi	பரதேசி
paradesi	பரடிஷ்
paradhesi	பரத்தி
parathaechi	பரத்தேசி
parathesi	பரத்தி
parapalavai	பரபாவவை
parappalavai	பரப்பவவை
parappazhavai	பரப்பவழை
parappurai	பரப்புறை
parappuraigalai	பரப்புறைகளை
parappuraigazhai	பரப்புறைகளை
parappuraikalai	பரப்புறைகளை
parichoathiththu	பரிசோதித்து
parisoathiththu	பரிசோதித்து
parimaatraththil	பரிமாற்றத்தில்
parimaattraththil	பரிமாற்றத்தில்
parimaatraththai	பரிமாற்றத்தை
parimaattraththai	பரிமாற்றத்தை
parimaatramum	பரிமாற்றம்
parimaattramum	பரிமாற்றும்
parumanaal	பருமானல்
paruman	பருமன்
barnaalaa	பரிநாலா
barnala	பரிநால்
parnaalaa	பர்நாள
parikka	பரிக்க
parikkum	பரிக்கும்
palagaigal	பழகைகள்
palagaikal	பழகைகள்
palakaikal	பழகைகள்
palagaiyin	பழகையின்
palakaiyin	பழகையின்
palagaiyil	பழகையில்
palakaiyil	பழக்கையில்
balaththa	பளத்த
palaththa	பளத்த
palaridam	பளரிடம்
palavaaraaga	பழவாறார்
palavaaraaka	பழவாறார்
paliyiduthal	பலியிடுத்தல்
paliyiduvathu	பலியுவிடது
pallavargal	பல்ளவர்கள்
pallum	பெளும்
balu	ெபு
palu	ெபு
pazhu	நோது
bharathi	பரதி
palani	பணில்
parati	பராத்தி
pazhani	பழனி
pazhu	நோது
pazhavaettaraiyar	பழவைத்தியர்
pazhuvettaraiyar	பழுவிட்டையர்
pavi	விப்ப்
paula	நோரா
paulaa	புளா
pauula	பூரியா
pauulaa	பூரளவ
pavula	வருள்
poola	நோர்
pula	நூரை
paakisthaanukku	பாகிஸ்தான்க்கு
pakistanukku	பாக்சிந்தங்கு
pakisthanukku	பகித்நாங்கு
paagupaadu	பாகுவாடு
paakupaadu	பாகுபாடு
paagupaadum	பாகுபாடும்
paakupaadum	பாகுபாடும்
baacyaraaj	பாய்சராஜ்
baagyaraaj	பாய்காரா
baakkiyaraaj	பாக்கியார
baakyaraaj	பாக்காரா
bagyaraj	பாகியர்
bakyaraaj	பக்கராஜ்
bhakkiyaraaj	பக்கியார
baangaak	பிங்காக்
baangkaak	பிங்காக்
bangkok	பண்குக்
bangqoq	பங்கோக்
pankak	பண்க்க
paandavargalil	பாண்டவர்களில்
paandavarkalil	பாண்டவர்களில்
paantavarkalil	பாண்டவர்களில்
pandavargalil	பண்டவர்களில்
paandavargalukkum	பாண்டவர்களுக்கும்
paandavarkalukkum	பாண்டவர்களுக்கும்
paantavarkalukkum	பாண்டவர்களுக்கும்
pandavargalukkum	பண்டவர்களுக்கும்
paandavargalum	பாண்டவர்களும்
paandavarkalum	பாண்டவர்களும்
paantavarkalum	பாண்டவர்களும்
pandavargalum	பண்டவர்களும்
paandavargalai	பாண்டவர்களை
paandavarkalai	பாண்டவர்களை
paantavarkalai	பாண்டவர்களை
pandavargalai	பண்டவர்களை
paandavargal	பண்டவர்கள்
paandavarkal	பண்டவர்கள்
paantavarkal	பண்டவர்கள்
pandavargal	பண்டவர்கள்
baathagaththai	பாதகத்தை
paathagaththai	பாதகத்தை
paathakaththai	பாதகத்தை
baathip	பித்தி
paathip	பித்தி
paadhiyaaga	பாதியாக
paathiyaaka	பாதியாக
paadhiyil	பாியில்
paathiyil	பாியில்
baathai	பாதி
paathai	பாதி
baathaikalin	பாதைகளின்
paathaikalin	பாதைகளின்
baathaikalum	பாதைகளும்
paathaikalum	பாதைகளும்
baathaikalai	பாதைகளை
paathaikalai	பாதைகளை
baathaaikku	பாதாக்கு
paathaaikku	பாதாயுக்கு
paathaikku	பாதைக்கு
paathaiyil	பாதையில்
paathaiyai	பாதையை
paathaiyaik	பாதையைக்
paathaiyaip	பாதையைப்
baanangal	பானங்கள்
baanangkal	பானங்கள்
baanankal	பணண்கள்
paanankal	பானங்கள்
baanaththil	பானத்தில்
paanaththil	பானத்தில்
baanaththai	பானத்தை
paanaththai	பானத்தை
baanam	பணம்
paanam	பணம்
baabaavin	பாவாபின்
babeel	பெபில்
babel	பெப்
baebal	பீப்
baebel	பெபில்
baeebal	பீப்
baeebeel	பீபில்
beeybalee	பெப்லே
beibale	பெபாளி
beybale	பெய்லா்
papeel	பெப்வேல்
baarathiya	பரதிய
bhaarathiya	பரதிய
bharathiya	பரதிய
baarathiyaar	பாரதியார்
bhaarathiyaar	பாரதியார்
bharathiyaar	பாரதியார்
paariya	பரியா
paariyalavilaana	பாரியளவியாளர்
baaru	வருது
paaru	வருது
paarkkum	பார்க்கும்
paalum	புரும்
paaluravu	பாருவு
paalootti	பொழல்டி
paaluutti	பாலுட்டி
paaloottigalil	பாலூட்டிகளில்
paaloottikalil	பாலோட்டிகளில்
paaluuttigalil	பாலுட்டியாள்கில்
paaluuttikalil	பாலுட்டியாளில்
paaloottigal	பொழட்டிக்கில்
paaloottikal	பாலோட்டிக்
paaluuttigal	பாலுட்டிக்கள்
paaluuttikal	பாலுட்டிக்கள்
paal	பில்
paazh	பெளு
baava	போவி
bhaava	போவி
paava	போவி
bhaavangalukku	பாவங்களுக்கு
paavangalukku	பாவங்களுக்கு
paavangkalukku	பாவங்களுக்கு
paavankalukku	பாவங்களுக்கு
bhaavangal	பாவங்கள்
paavangal	பாவங்கள்
paavangkal	பாவங்கள்
paavankal	பாவங்கள்
baavanai	பவவணை
bhaavanai	பவவணி
paavanai	பவவணை
baavanaiyil	பாவணையில்
bhaavanaiyil	பாவணையில்
paavanaiyil	பாவணையில்
bisin	ிிசங்
pichin	ிிசின்
pisin	ிிசன்
pithappai	பிதப்பை
piththappai	பித்தப்பை
bindhu	நிப்து
pinthu	நிது
pinbura	பினுவர்
pinpura	பினுப்பா
pinburamaaka	பின்புமாக
pinpuramaaga	பின்புமாக
pinpuramaaka	பின்புமாக
binvaanginaar	பின்வான்கினார்
binvaangkinaar	பின்வாங்கினார்
pinvaanginaar	பின்வாங்கினார்
pinvaangkinaar	பின்வாங்கினார்
pigmees	பிக்மீஸ்
pigmies	பிமிக்ஸ்
pygmees	பிக்மேஷ்
pygmies	பிமிக்ஸ்
pygmiis	பிமிக்ஸ்
pyjmees	பிமீஸ்
pyjmies	பிமிஸ்யில்
pirachaara	பிரசார்
pirasaara	பிரசார்
prachaara	பிரசாய்
pirachaaram	பிரசாயம்
pirasaaram	பிரசாம்
prachaaram	பிரச்சாம்
pirachurankal	பிரசுரங்கள்
pirasurangal	பிரசுரங்கள்
pirasurangkal	பிரசுரங்கள்
prachurankal	பிரசுச்னர்கள்
prasurankal	பிரசுராங்கள்
pirachuram	பிரசும்
pirasuram	பிரசும்
prachuram	பிரசும்
prasuram	பிரசும்
piradhaanap	பிரதானப்
pirathaanap	பிரதானப்
piradhaanamaaga	பிரதானாக
pirathaanamaaka	பிரதானமாக
piradhaanamaana	பிரதானான
pirathaanamaana	பிரதானமான
piraththiyaekamaaka	பிரத்தியாகவாக
pirathyaekamaaka	பிரதியாகமாக
pirathyeagamaaga	பிரதியாகமாக
piraththiyaekamaana	பிரத்தியானமான
pirathyaekamaana	பிரதியாகமான
pirathyeagaamana	பிரதியாகான
cankar	சங்கர்
pirapu	பிருப்
prabhoo	பிரோது
prabhu	பிருத்
prabhuu	பிருத்
prabu	பிரோது
prabuu	பிரைபு
sangkar	சங்கர்
sankar	சங்கர்
shankar	சங்கர்
pirabhukkal	பிரபுக்கள்
pirabukkal	பிரபுக்கள்
prabukkal	பிரபுக்கள்
pirabhuvin	பிரவுபின்
pirabuvin	பிரவுப்
prabhuvin	பிரவுஷ்ணி
prabuvin	பிரவுப்
probuvin	பிருப்போன்
bhramma	பிரம்ம்
biramma	பிரமும்
brahma	பிரம்
brahmma	பிரம்ம்
bramma	பிரம்ம்
piramma	பிரமும்
brammaththai	பிரம்மத்தை
pirammaththai	பிரமம்தத்தை
brammanai	பிரம்மணை
pirammanai	பிரம்மணை
brammam	பிரம்ம்
pirammam	பிரமமம்
pirammum	பிரமும்
piraveen	பிரவின்
praveen	பிரவிு
piravaecha	பிரவேச்
piravaesa	பிரவேச்
piravesa	பிரவேச்
pravaesa	பிரவேச்
braamanargalum	பிராமன்றுகளும்
braamanarkalum	பிராமன்றுகளும்
piraamanarkalum	பிராமனர்களும்
praamanarkalum	பிராமன்றகளும்
piritha	பிரித்த
piriththa	பிரித்த
priththa	பிரித்த
pirithanar	பிரித்தன்
piriththanar	பிரித்தனர்
priththanar	பிரித்தனர்
pirithaar	பிரிதாத்
piriththaar	பிரித்தார்
priththaar	பிரித்தார்
pirivinarae	பிரிவினாய
privinarae	பிரிவினாய
piraemaa	பிரமை
praemaa	பிரமை
prema	பிரமி
premaa	பிரைமா
piraem	பிரமும்
pireem	பீரியம்
praem	பிரைம்
praim	பிரைம்
preeim	பீரியம்
preem	பிரியம்
preemm	பிரீமும்
preim	பிரையும்
prem	ிரைப்
premm	பிரமிம்
talankalil	தலங்களில்
thalanagalil	தளகனில்
thalangalil	தளங்களில்
thalangkalil	தலங்களில்
pirandhadhaaga	பிரந்ததாக
piranthathaaka	பிரந்ததாக
pirandhadhaal	பிரந்ததால்
piranthathaal	பிரந்ததால்
pirandhadhu	பிரந்தது
piranthathu	பிரந்தது
pirandhana	பிரந்தன
piranthana	பிரந்தன
pirandhanar	பிரந்தனர்
piranthanar	பிரந்தனர்
pirandhapoadhu	பிரந்தபோது
piranthapoathu	பிரந்தபோது
piranthapoothu	பிரந்தோபோது
piranthavudan	பிறந்தவுடன்
piranthavutan	பிறந்தவுடன்
piranthavai	பிரந்தவை
vittaal	விட்டால்
vittal	விட்டுள்
piranthirullathu	பிரந்திருள்ளது
piranthullathu	பிரந்துள்ளது
pirappai	பிரப்பை
pirarukku	பிரறுக்கு
piraroadu	பரியோது
piraroatu	பரியோடு
piraroodu	பரியோது
pirkaala	பிர்கால்
pirkaalangalil	பிர்காலங்களில்
pirkaalanggalil	பிராக்காளங்கில்
pirkaalangkalil	பிராக்காளங்கில்
pirgaalaththu	பிர்காலத்து
pirkaalaththu	பிர்காலத்து
pele	ெண்லை
pilae	பெளை
blackberry	பிலக்க்ரிர்
pilaakperri	பிலாப்பிரிரி
pilaalperri	பிளாப்பிர்சி
plackperry	பிளக்க்ரூரி
pilaanet	பிலாண்டு
pilaant	பிளாந்து
plaant	பிளான்
planet	பிளன்
plant	பிளன்
pilai	பிளை
pizhai	பிளை
pilaikalai	பிளைகளை
pizhaigalai	பிழைகளை
pilaikal	பிளைகள்
pizhaigal	பிழைகள்
pilaiyaaka	பிளையாக
pizhaiyaaga	பிழையாக
be	ீஅஸ்
bea	நீப்
bee	ெப்பி
bii	ரைபி
pee	ெப்பி
pii	ியிப்பு
beatti	விட்டி
beatty	விய்ட்
beaty	பிய்ட்
beetty	பெட்டி
betty	பெட்டி
piiddi	ிடிப்
beatlej	பெட்சில்
beatles	பெட்லிஸ்
beatless	பிட்லஸ்
beatlez	பெட்லில்
beetles	பீட்லி்
beetless	ப்டிலஸ்
beetlez	பீட்லில்
betles	பெட்லி்
betless	ப்டலிஸ்
betlez	பெட்லில்
biitles	பிட்லில்
beepi	பிப்பி
peepe	பெப்
peepi	பிப்பி
beeris	பிரிஸ்
peeris	பிரிஸ்
pugalpetrtra	புகாலிப்ற்ற
pukalpetrtra	புகல்பெற்றா
pukalpettravai	புக்கவிற்றவை
pukazhpetra	புகழ்ப்பெற்
pukazhpettravai	புக்கவற்றைவை
pugalpetrtravai	புகாப்பிர்வேரை
pukalpetrtravai	புக்கவற்றைவே
pukalpettravai	புக்கவிற்றவை
pukazhpetravai	புக்கவற்றைவை
pukazhpettravai	புக்கவற்றைவை
pugalpetrtraar	புகல்ப்பெற்றார்
pukalpetrtraar	புக்காற்றுப்பார்
pukalpettraar	புகல்ப்ர்ட்ரார்
pukazhpetraar	புக்கற்றிபார்
pukazhpettraar	புக்கற்ற்பார்
pugaaril	புகாரில்
pukaaril	புகாரில்
pudhusu	சுதுபு
puthusu	சுதுபு
puduchcheari	புடுச்சாரி
puthuchchaeri	புதுச்சாரி
puthucheri	புதுச்ரி
puduchcheariyil	புடுச்சாரியில்
puthuchchaeriyil	புதுச்சேரியில்
puthucheri	புதுச்ரி
pudhuchcheariyai	புதுச்சாரியை
puthuchchaeriyai	புதுச்சேரையி
puthucheri	புதுச்ரி
pudhumai	புதுமை
puthumai	நூதுமை
pudhumaigalai	புதுமைகளை
pudhumaikalai	புதுமைகளை
puthumaigalai	புதுமைகளை
puthumaikalai	புதுமைகளை
pudhumaigal	புதுமைகள்
pudhumaikal	புதுமைகள்
puthumaigal	புதுமைகள்
puthumaikal	புதுமைகள்
pudhuvaiyil	புதுவையில்
puthuvaiyil	புதுவையில்
pudhuvaiyai	புதுவையை
puthuvaiyai	புதுவையை
pudhaiththu	புதைத்து
puthaiththu	புதைத்து
buddharin	புதிரத்ன்
budhdharin	புத்தினர்
buththarin	புத்திரன்
puththaandup	புத்தான்பு
punidhar	புணித்த
punithar	புனித்த
punidhargal	புணிதர்கள்
punitharkal	புணிதிராகள்
punaindhu	புனைந்து
puratchigara	புரட்சிகார
puratchikara	புரட்சிகார
purigindrana	புரிகின்றன
puriginrana	புரிக்கின்றன
purikindrana	புரிக்கின்றன
puriginaranar	புரிகினாரனர்
purigindranar	புரிகின்றனர்
purikindranar	புரிகின்றனர்
puridhal	புரிதல்
purithal	புரித்தல்
purindhum	புரிந்தும்
purinthum	புரிந்தும்
purivadhu	புரிவது
purivathu	புரிவது
puraa	நூரை
puraakkal	புராக்கள்
puraavin	புராவின்
noayaaga	நோயாக
noayaaka	நோயாக
noyaka	நோயாகு
pulambi	புழம்பி
pulampi	புழம்பி
pulampeyarnthu	புலம்பெயர்ந்து
pulavar	புளவர்
pulavargalai	புலவர்களை
pulavarkalai	புலவர்களை
pulavargal	புவலர்கள்
pulavarkal	புவலர்கள்
eerppu	எற்பு
irppu	இறுப்பு
puviyeerppu	புவியேற்பு
puviyai	விபுயா
poongulali	பூங்குளலி
poonguzhali	பூங்குழலி
puungkulalil	பூங்குளளில்
poochchu	பூச்சு
puuchchu	பூசுச்
poochchugal	பூச்சுகள்
poochchukal	பூச்சுகள்
puuchchugal	பூசுக்கள்
puuchchukal	பூசுக்கள்
bhutan	ிுடன்
poodaan	பூடன்
pootaan	பூடான்
puudaan	புடான்
puutaan	புடான்
boaut	பிரு
boauut	பிருத்
boot	னுப்
but	னுப்
puud	பிரு
poonagariyil	பூணகரியில்
poonakariyil	பூணகரரித்
puunagariyil	பூணகரியில்
puunakariyil	பூணகரியில்
poona	நோயா
poonaa	பூண
puna	நூரா
punaa	நுபா
pune	ெனு
puuna	ூணி
puunaa	புணா
poonai	பூணை
puunai	பூணை
poonaiyin	பூணையின்
becki	பிக்கி
becky	பெக்கி
becqy	பெக்கி
paekki	ப்பிக்
peggi	பிக்கே
peggy	பிக்கே
pennukkum	பெணுக்கும்
peyaraal	பெயரால்
peyarinai	பெயரினை
peyarin	பெயரின்
peyarilum	பெயரிலும்
peyaro	பெயுர்
peyaroa	பெயோரா
peyaroo	பெயோரு
periyadhaaga	பெரியாக
periyathaaka	பெரியதாக
periyadhaagavum	பெரியாகவவும்
periyathaakavum	பெரியாகவவும்
periyadhu	பெரியது
periyathu	பெரியது
periyadhum	பெரியதும்
periyathum	பெரியதும்
periyar	பிரியர்
periyavaraaga	பெரியவாாக
periyavaraaka	பெரியவாாக
periyaarin	பெரியாரின்
periyarin	பெரியரின்
periyaarukku	பெரியாருக்கு
periyarukku	பெரியருக்கு
perugiyathu	பெறுகியது
perukiyathu	பெறுகியது
peruthal	பெறுத்தல்
peruvathargaaga	பெறுவதற்காக
peruvatharkaaga	பெறுவதற்காக
peruvatharkaaka	பெறுவரத்தாக
peruvatharkaagavum	பெருவரத்தாகவும்
peruvatharkaakavum	பெருவரத்தாகவும்
petrtruththanththathu	பெற்றுத்தன்தது
pettruththandhadhu	பெறுத்து்நடத்து
pettruththanththathu	பெறுத்து்தட்தது
baurnami	புரண்மி
paurnami	புரண்மி
pournami	பூரணமி
powrnami	புரண்மி
pack	பாய்
pacq	ணச்பு
paeek	பீப்
paek	பீப்
paeq	பியாக்
paik	பியாக்
paiq	ைப்பு
pak	பஞ்
paq	ணப்பு
peek	பீப்
pek	ணீப்
paechupavarkal	பேசுப்பவர்கள்
paesubavargal	பேசுபாரப்கள்
pesupavarkal	பசசுப்பார்கள்
paeththi	பெத்தி
peaththi	பித்தி
peththi	பித்தி
bearaasiriyarum	பேராசிரியரும்
paeraasiriyarum	பேராசிரியரும்
pearaasiriyarum	பேராசிரியரும்
baee	பெய்
bai	பியா
baii	பியாதி
bie	ீரை
biee	ிரை
bye	ெய்வே
byee	ிய்வே
byii	ியைப்
paai	பியா
paaii	பியாதி
pae	பெய்
pai	பியா
paii	பியாதி
pie	ிரை
piie	ீரை
paigalil	பைகளில்
paikalil	பைகளில்
paigal	பிகள்
paikal	பிகள்
paitan	பிடன்
paithon	பியதோன்
paithonn	பியததனன்
paython	பியத்து
pethonn	பெனதுன்
pithon	பினத்
pithonn	பினத்தின்
python	ிியோத்
pythonn	பினத்தின்
baibil	பிபில்
bible	பிப்லே
paipil	பிபில்
paiyanai	பயயணை
paiyin	பியன்
paiyil	பியலில்
pongku	பொன்கு
pongu	னோப்பு
pongkum	பொங்கும்
pongum	பொன்கும்
pottu	ஒர்புடு
podhumai	பொதுமை
pothumai	பொதுமை
ponnaiyum	பொன்னையும்
poriththu	பொரித்து
poruththappattana	பொருத்தப்பட்டன
poruththappattirukkum	பொருத்தப்பட்டிருக்கும்
porundha	பொருந்த
porundhdha	பொருந்தா
poruntha	பொருந்த
porundhavillai	பொருத்தாவில்லை
porundhdhavillai	பொருத்தாவில்லை
porunthavillai	பொருத்தாவில்லை
porulaaga	பொருளாக
porulaaka	பொருளாக
porulaagavum	பொருளாவுும்
porulaakavum	பொருளாவகும்
porulaagaum	பொருளாகும்
porulaakum	பொருளாகும்
poraamai	போரமை
poraamaiyin	போரமையின்
porimurai	பொரிமுறை
poruththadhu	பொருத்தது
poruththathu	பொருத்தது
poruppaettra	பொறுப்பெற்ற
poruppeattra	பொறுப்பிட்டா
poruppetra	பொறுப்பெற்ற
porupeattradhu	பொருப்பாற்றது
poruppaettrathu	பொறுப்பாற்றது
poruppetrathu	பொறுப்பாற்றது
poruppaettru	பொறுப்பெற்று
poruppetru	பொறுப்பெற்று
poruppettru	பொறுப்பெற்று
polanaruvai	போனதுவாரை
poolanaruvai	பூலனுரைவ
poluthupokkaaka	பொழுதுக்கொண்காக
poluthupookkaaka	பொழுதும்புக்காக
pozhudhupoakkaaga	பொழுதுக்கோடாக
poluthupokku	பொழுதுப்புக்கு
poluthupookku	பொழுதுப்புக்கு
pozhudupoakku	பொழுதுப்கோக்கு
poluthum	பொழுத்தும்
pozhudhum	பொழுத்தும்
poaga	ோபாக்
poga	ோபாக்
poagap	போப்
pogap	போப்
bhogi	ோபி
boagi	ோபி
bogei	பஞ்சி
bogey	பிக்கே
bogi	னிப்
bogie	பிரைக்
boogey	புஜ்
boogie	பூரை
poagi	ோபி
pooki	ரூப்பி
poagiraen	போரியன்
poagirean	போரியான்
poagumboadhu	போக்குவோது
poagumpoathu	போகும்போது
poakkuvaraththil	போக்குவரத்தில்
poakkuvaraththai	போக்குவரத்தை
boat	னப்
poat	னப்
poatti	ோப்படி
poattigalai	போட்டிகளை
poattik	போட்டிக்
poattikkaaga	போட்டிக்காக
poattikkaana	போட்டிக்கான
poattiyaana	போட்டியான
poattiyaanathu	போட்டியானது
poattiyaandahu	போட்டியானது
poatiyaalar	போடியாளர்
poattiyaalar	போட்டியாளர்
poattiyaalargal	போட்டியாளர்கள்
poattiyaalarkal	போட்டியாளர்கள்
poattiyin	போட்டியின்
poattiyilum	போட்டியிலும்
poattiyil	போட்டியில்
boatil	பூடில்
boattil	போட்டில்
poattil	பூட்டில்
poandra	நோய்ட்ர
poanra	னோர்ற
poantra	நோய்ற
poayinar	பியன்ற்
poyinar	பியன்ற்
bauron	பரரூண்
bauroon	பரரூண்
bauuron	பரரூண்
boaraan	புரண்
booraun	புரண்
booroon	பரரூண்
boraun	பரணவு
borauun	பரூஜு
boron	ரனன்
poaraan	புரண்
pooran	ரணருப்
poarththukkaeyar	போர்த்துக்காயர்
poarththukkeyar	போர்துத்குகியார்
porththukkeyar	பொர்துக்குடார்
portugaeyar	பொறுத்தாய்
poala	ோபுள்ள
pola	ோர்வு
poalath	போலத்
polath	போலத்
poalavum	போழவும்
polavum	பொழுவம்
poalavoa	போலவு
polavo	போலவு
bola	ோர்வு
bolaa	போராவி
bolla	ொர்லை
boola	நோரா
boolaa	பூராவ்
boolla	ோர்லை
bula	நூரை
poola	நோர்
poavathu	போவது
povathu	வோது
poavathum	போவதும்
povathum	போவதும்
bro	னோர்ப்
broa	நோராதி
fro	னராதி
pro	னோர்ப்
proa	நோராதி
magadha	மகத்த
magatha	மகத்த
makadha	மகத்த
makatha	மகத்த
magalaith	மகளைத்
makalaith	மகளைத்
makalath	மகளத்
magaa	மாக
magha	மக்
maghaa	மாக
majha	மஞ்சா
majhaa	மஞாச்
maka	மாக்க
makaa	மாக்
magaadaevi	மகாதிவி
magaadevi	மாகாவி
magaadhaevi	மகாதிவி
magaathaeve	மகாதேவே
mahadevi	மாகவேதி
makaadaevi	மகாதேவி
makaadhaevi	மகாதிவே
makaathaevi	மகாதிவே
mahaaiana	மகாயான்
mahaayana	மகாயான
mahaiaana	மகாயான
mahaiana	மகான
mahaianaa	மகானா
mahayaana	மகாயான
mahayana	மகான
mahayanaa	மகநாயா
makayan	மகயன்
magaalatchumi	மகால்்டிசு
mahaalaksmi	மகாலாஷ்மி
mahalatchumi	மகாத்தூிி
makaalatchumi	மகால்்டிசு
magaaveerar	மகாவீர்
mahaveer	மகவிவே்
mahaveerar	மகவீரவர்
makaaveerar	மகாவீர்
magaaveer	மகாவீவ்
mahaveer	மகவிவே்
makaaveer	மகாவீர்
magilnthu	மகிழ்ந்து
magizhunthu	மகிழுந்து
makilnthu	மகிழ்ந்து
makizhunthu	மகிழுந்து
magilchchi	மகிழ்ச்சி
magizhchchi	மகிழ்ச்சி
makilchchi	மகிழ்ச்சி
makizhchchi	மகிழ்ச்சி
magilchchiyaaga	மகிழ்சியாக
makilchchiyaaka	மகிழ்சியாக
makizhchchiyaaka	மகிழ்சியாக
magilchchiyaana	மகிழ்சியான
makilchchiyaana	மகிழ்சியான்
makizhchchiyaana	மகிழ்சியான
magilchchiyil	மகிழ்சியில்
makilchchiyil	மகிழ்சியில்
makizhchchiyil	மகிழ்சியில்
magilchchiyutan	மகிழ்ச்சியுடன்
makilchchiyudan	மகிழ்ச்சியுடன்
makizhchchiyudan	மகிழ்சியியுந்
magilchchiyum	மகிழ்சியியும்
makilchchiyum	மகிழ்சியியும்
makizhchchiyum	மகிழ்சியியும்
mahesan	மெகஷண்்
makaechan	மகசின்
makaesan	மகசனன்
maahees	மேஷ்
maahes	மாஷ்
maahesh	மாஷிஷ்
mahees	மேஷ்
maheesh	மகேஷ்
mahes	மெஷ்
mahesh	மஹீஷ்
maheshh	மஹீஷ்
makaesh	மகேஷ்
makeesh	மெகிஷ்
machuuthikku	மசுதித்கு
masoothikku	மசோதிக்கு
masuthikku	முதிசுக்கு
masuuthikku	முதிசுக்கு
machuuthiyin	முசதிதின்
masoothiyin	மசூதியின்
masuthiyin	முதியின்
masuuthiyin	முசதிதின்
machuuthiyai	மசுதியை
masoothiyai	மசோதியை
masuthiyai	முத்தியை
masuuthiyai	முதோதியை
manjula	மஞ்சுள்
manjulaa	மஞ்சுள்
manamaagaatha	மனமாகாத
manamaakaatha	மனமாகாத
maninaeramum	மனினேரமும்
manineramum	மனினேரமும்
maniyam	மணியம்
mandaal	மந்தால்
mandal	மண்டுள்
mathippaaga	மதிப்பாக
mathippaaka	மதிப்பாக
mathippeettai	மதிப்பெடைத்
madhdhiya	மத்திய
maththiya	மத்திய
madhdhiyatharaik	மத்தியததரைக்
maththiyatharaik	மத்தியத்தைக்
pirateca	பிரடியா
piratecam	பிரடியம்
pirathaesa	பரததே
pirathaesam	பிரதேசம்
piratheasa	பிரதியா
pradhaesa	பிரத்தே
pradhaesam	பிரதேசம்
mandha	மந்த
mantha	மந்த
mandhamaana	மந்தமான
manthamaana	மந்தமான
mandham	மந்தம்
mantham	மந்தம்
manitharai	மனிதரை
manai	மணை
manaigal	மணைகள்
manaikal	மணைகள்
manaikku	மணைக்கு
marakkattaigal	மரக்கட்டைகள்
marakkattaikal	மரக்கட்டைகள்
marabinar	மரிபானி
maravallik	மரவளில்
maravallilk	மரவள்ளில்
maruththuvamanai	மருத்தும்வனை
maruththuvamanaigalil	மருத்துவைகளினை
maruththuvamanaikalil	மருத்துவைகளினைில்
maruththuvamanaigalum	மருத்துவையனாகும்
maruththuvamanaikalum	மருத்துவியங்காவும்
maruththuvamanaigal	மருத்துமைவனால்
maruththuvamanaikal	மருத்துமைவனகள்
maruththuvamanaiyai	மருத்துமைவையான்
marunthin	மருந்தின்
marunthil	மருந்தில்
marai	மாரை
marainr	மறியன்
marinar	மறினர்
mariner	மறினிர்
marain	மைரன்
marine	மரினி
marukka	மறுக்க
marukkappattu	மறுக்கப்பட்டு
marukkavae	மறுக்கவே
vittaargal	விட்டிறாகள்
vittaarkal	விட்டிறாக்
vittarkal	விட்டிரள்
matravargalidam	மற்றவர்களிடம்
matrtravarkalidam	மற்றவர்களிடம்
matrtravarkalitam	மற்றவர்களிடம்
mattravarkalidam	மற்றவர்களிடம்
matravargalin	மற்றவர்களின்
matrtravargalin	மற்றவர்களின்
matrtravarkalin	மற்றவர்களின்
mattravarkalin	மற்றவர்களின்
matravargalum	மற்றவர்களும்
matrtravargalum	மற்றவர்களும்
matrtravarkalum	மற்றவர்களும்
mattravarkalum	மற்றவர்களும்
matravargalaith	மற்றவர்களைத்
matrtravarkalaith	மற்றவர்களைத்
mattravarkalaith	மற்றவர்களைத்
matravargalaiyum	மற்றவர்களையும்
matrtravargalaiyum	மற்றவர்களையும்
matrtravarkalaiyum	மற்றவர்களையும்
mattravarkalaiyum	மற்றவர்களையும்
matravargal	மற்றவர்கள்
matrtravargal	மற்றவர்கள்
matrtravarkal	மற்றவர்கள்
mattravarkal	மற்றவர்கள்
malarae	மறை
malaraiyum	மலரையும்
malargalil	மலர்களில்
malarkalil	மலர்களில்
malargalaik	மலர்களைக்
malarkalaik	மலர்களைக்
malargalaith	மலர்களைத்
malarkalaith	மலர்களைத்
malargalaiyum	மலர்களையும்
malarkalaiyum	மலர்களையும்
malarmaalai	மலர்மாலை
malaiyadivaara	மலையவிட்டார்
malaiyadivaaraththil	மலையாடவியதித்தில்
maadan	மானத்
maatan	மானத்
modern	முடர்தின்
maanikka	மானிக்க
manicka	மனிக்க
manickka	மனிக்க்க
maanikkam	மானிகம்
manickam	மனிக்கம்
maadhulai	மாதுளை
maathulai	மாதுளை
maara	மரித்
mara	மரியா
maraa	மார்
maarbai	மரைப்
maarpai	மர்ப்பை
maaraaga	மாராய்
maaraaka	மாராக்
maattramadaiyum	மாற்றதமையும்
mattramadaiyum	மற்றமையடும்
thiranaaligalukkaana	திறாணலிக்களுக்றன
thiranaalikalukkaana	திறாணலிக்களுக்றன
tiranalikalukkana	திரணளிகளிக்கான
maattrup	மாற்றுப்
maatruvathai	மாற்றுவதை
maattruvadhai	மாற்றுவதை
maattruvathai	மாற்றுவதை
maali	முளி
maalii	மிழை
mali	முளை
malii	மெளி
maalik	முளிச்
malik	முளிக்
maliq	முளைச்
maalai	மாளை
malai	மையி
maalaigal	மாளைக்
maalaikal	மாளைக்
poluthil	பொழுத்தில்
polutil	பொழுத்தில்
pozguthil	பொழுத்தில்
pozhuthil	பொழுத்தில்
maalaiyum	மாலையும்
maalaiyai	மாளையை
maaligaikku	மாளிகைக்கு
maalikaikku	மாளியைக்கு
maaligaiyilirundhu	மாலைகியியிருந்து
maalikaiyilirunthu	மாலைகியியிருந்து
maaligaiyil	மாளிக்கையில்
maalikaiyil	மாளிக்கையில்
maasgoavin	மாக்கோவின்
maaskoavin	மாக்கோவின்
maaskoovin	மாக்கூவின்
moscowin	மிஸ்கோன்
mikkadhaagavum	மிக்காாவுு
mikkathaakavum	மிக்காதவாுும்
mikkadhu	மிக்கது
mikkathu	மிக்கது
mikkavan	மிக்கவன்
mikkavaraaga	மிக்கவாாக
mikkavaraaka	மிக்கவாாக
mikkavar	மிக்கவர்
mikkavargal	மிக்கவர்கள்
mikkavarkal	மிக்கவர்கள்
mikkavai	மிக்கவை
mickee	மெக்கே
mickei	மிக்கே
mickey	மிக்கே
micki	மிக்கி
mickii	விக்கி
mickiy	மிக்கியி
micky	மிக்கி
micqee	மெக்கே
micqey	மிக்கே
micqii	மிக்கி
micqiy	மிக்கியி
micqy	மிக்கி
mikei	மியை
mikey	மிக்கே
mikii	மிக்கி
mikki	மிக்கி
miqey	மிக்கே
miqii	மிக்கி
miththiran	மித்திரன்
mesion	மிசன்
mishan	மிஷன்
mision	மிஷியன்
misionn	மிஷியன்
mission	மிஷ்சன்
meenavar	மீனவர்
meenavargalukku	மீனவர்களுக்கு
meenavarkalukku	மீனவர்களுக்கு
meenvarkalukku	மீன்வர்களுக்கு
pidikka	திடிக்கப்
pitikka	திரிக்கப்
meengalin	மீன்களின்
meenkalin	மீன்களின்
meengalukku	மீங்களுக்கு
meenkalukku	மீன்களுக்கு
meengalaiyum	மீங்களையும்
meenkalaiyum	மீங்களையும்
meenkalayum	மீங்களையும்
mugaththuvaaraththil	முகுத்துவாரத்தில்
mukaththuvaaraththil	முகுத்தாவத்திலில்
mugaththuvaaram	முகத்துவாறம்
mukaththuvaaram	முகத்துவாறம்
mugamaaga	முகாமாக
mugamaaka	முகாமாக
mukamaaka	முகாமாக
mugamaagavum	முகாகவாமும்
mugamaakavum	முகாகவாமும்
mukamaakavum	முகாகவாமும்
makammathu	மகமுத்து
mohammedhu	மாமுத்தம்
mugammathu	முகம்மது
muhammad	முகமும்
mukammathu	முகம்தும்
mugaitheen	முகைதேன்
muhaideen	முகேயுடின்
muhaitheen	முதையின்
mukaitheen	முகைதேன்
mukthaa	முத்தா
mukkthi	முக்தி
mukthi	முத்தி
muchuleem	முசுலியம்
musleem	முஸ்லியம்
muslim	முஷ்லியம்
musuleem	முசுலியம்
musulim	முசுலிம்
mudindhdhathu	முடிந்தது
mudindthathu	முடிந்தது
mudinthathu	முடிந்தது
mudindhdhathum	முடிந்ததும்
mudindthathum	முடிந்ததும்
mudinthathum	முடிந்ததும்
mudindhdhapoathu	முடிந்தபோது
mudinthapoathu	முடிந்தபோது
mudindhdhavudan	முடித்துடவுடன்
mudinthavudan	முடித்துவன்
mudindhdhaalum	முடிந்தாலும்
mudinthaalum	முடிந்தாலும்
mudindhdhaal	முடிந்தால்
mudinthaal	முடிந்தால்
mudippu	முடிப்பு
mudiyudai	முறியுடை
mudivirku	முடிவிற்கு
mudivilaa	முடிவிலா
mudivil	முடிவில்
muthaliya	முதலிய
muthaliyana	முதலியான
muthaliyanavum	முதலியனானும்
muthaliyavargal	முதலியவர்கள்
muthaliyavarkal	முதலியவர்கள்
muthaliyoar	முதலியார்
muthaliyor	முதலியூர்
muththa	முத்த
muththai	முத்தை
muthaiya	முதைய
muththaiya	முத்தைய
muththaiyaa	முத்தையா
mundhi	முந்தி
munthi	முந்தி
munthik	முந்திக்
munanikku	முனனிக்கு
munnanikku	முன்னனிக்கு
munnaniyin	முன்னனியின்
munnaniyai	முன்னனியை
munnuthaaranamaaga	முன்னுமதற்கான
munnuthaaranamaaka	முன்னுமதற்கான
munnedukka	முன்னெடுக்க
munnetukka	முன்னெடுக்க
munmaadhiri	மும்மாதிதி
munmaathiri	மும்மாதிதி
munmadiri	முன்மதிதி
munmaathiriyai	முன்மாதிதியை
munmadiriyai	முன்மடிரையி
munmathiriyai	முன்மதிதியை
munvaiththathu	முன்வைத்தது
munvaiththaar	முன்வைத்தார்
munvaiththu	முன்வைத்து
munvaiththullathu	முன்வைதுத்துள்ள
mupparimaana	முப்பிரமான
mummuramaaga	மும்முறாக
mummuramaaha	முமுமாறா
mummuramaaka	மும்முறாக
muyandranar	முயன்றனர்
muyanranar	முயன்றனர்
muyantranar	முயன்றனர்
muyandrapoathu	முயன்றப்பது
muyanrapoathu	முயன்றப்பது
muyantrapoathu	முயன்றப்பது
muyandraar	முயன்றார்
muyanraar	முயற்றார்
muyantraar	யுன்றார்
muyandraal	முயன்றால்
muyanraal	முயன்றால்
muyantraal	முயன்றால்
muyanrum	முயன்றும்
muyantrum	முயன்றும்
muraimaigalai	முறைமைகளை
muraimaikalai	முறைமைகளை
muraimaigal	முறைமைகள்
muraimaikal	முறைமைகள்
muraimaikku	முறைமைக்கு
muraimaiyai	முறைமையை
murpattathu	முற்பட்டது
murpattaar	முற்பாட்டார்
mulangka	முழங்க
muzhangka	முழங்க
mulavu	முழவு
muzhavu	முழவு
mauhamad	முதாம்
mauhammad	முதாமும்
mauuhammad	முதாமும்
mohamad	முதாம்
mohammad	முதாமம்
muhammad	முகமும்
muhammat	முகமுத்
muhammath	முகாமத்
muhammed	முமாம்த்
mookku	மூக்கு
mookkuk	மூக்கு
mookkum	மூக்கும்
moondrarai	மூன்றிய
moonrarai	மூன்றை
moondraaga	மூன்றாக
moonraaga	முன்றாக
moondraavadhum	மூன்றாவது
moondraavathum	மூன்றாவது
moondrilirundhu	மூன்றிலிருந்து
moondrilirunththu	மூன்றிலிருந்து
moondrilirunthu	மூன்றிலிருந்து
moondrae	முன்றே
moondre	முற்றி
moontrae	முற்றே
moorthi	வுர்தி
moorththi	வூர்த்தி
murthi	வுர்த்தி
moorthigal	மூர்திகள்
moorththigal	மூர்திகள்
moorththikal	மூர்திகள்
murthigal	முற்திகள்
moorthiyaaga	மூற்சியாக
moorththiyaaga	மூர்தியாக
murthiyaaga	முற்தியாக
moolakkoorugal	மூலக்கூருக்கா
moolakkoorukal	மூலக்கூருக்கா
moolamoa	மூலம்
moolashthaanaththil	மூல்்ததாநத்தில்
moolasthaanaththil	மூல்தாநத்தில்
moolgadikkappatta	மூல்கிடப்படுத்த
moolzhgadikkappatta	மூல்கிடப்படுத்திய
moozhgadikkappatta	முழகிடிகப்பட்ட
metti	மிட்டி
maethyoo	மெத்தோ
mathew	மெத்
maeni	மின்
maeniyai	மெனியை
meniyai	மெனியை
maenilai	மெனிலை
maeman	மிமன்
mamon	முன்
meman	மிமன்
maembaalap	மேம்பாலப்
maempaalap	மேம்பாலப்
meampaalap	மேம்பாலப்
maembaalam	மீம்பாலம்
maempaalam	மேம்பாலம்
meampaalam	மீமாப்பாம்
maelavai	மேலவை
maelavaiyil	மேலவையில்
maelmaruvaththoor	மேல்முறாத்தூவதி
melmaruvathur	மெல்முறாவதுது
maicroasaapt	மைக்கோர்ட்
maicroosooft	மைக்கூரூட்
maicrosoft	மைக்கொர்ட்
maicrosopht	மைக்கொரத்தோ
mecrosoft	மிக்ரூஷ்ட்
microosooft	மிக்ரூப்டோ
microosooftt	மிக்ரூப்டோட்
microowsooft	மிக்க்ரூவோட்
microsaaft	மிக்ரோஷ்ட்
microsoft	மிக்ரூஷ்ட்
microsoftt	மிக்ரூப்டோட்
microsopht	மிக்ரூஷ்போத்
microsophtt	மிக்ரூப்டத்
microvsoft	மிக்ரோவோட்ட்
microwsoft	மிக்ரோஸ்வோட்
microwsopht	மிக்ரூஷ்வோத்
maiyamaaga	மையாமாக
maiyamaaka	மையமாக
myyamaaka	மையமாக
maiyamaagak	மையமாகக்
maiyamaakak	மையமாகக்
myyamaakak	மையமாக்
maiyamaagavum	மையாகவும்
maiyamaakavum	மையமாகவும்
myyamaakavum	மையமாகவும்
mochchai	மூச்சை
moraaccoa	மாராச்சு
moraakkao	மோராக்கு
moraakkoa	மாராக்கு
morocco	முறோச்
moasae	மோய்
mosae	முஷ்
yaabbilakkanam	யாப்பிளங்கமனம்
yaappilakkanam	யாப்பிலங்கம்
yaaraavathu	யாரவது
yaaridamum	ஆரிதமாமும்
yaaritamum	யாரித்தாம்
yaaridam	யாரிடம்
yaaritam	யாரித்்
yaaaraenum	யாரணீம்
yaaraenum	யாரணீம்
unesco	அஞசுச்
yunesco	யூனிஷ்்
yuneskoa	யூனிசுச்
unescovin	உவிசுஷ்ணியன்
yunescoovin	யெஞ்சுவின்
yuneskoavin	யெனுச்சிவின்
iooe	ரையோ
iue	ரையோ
iuee	ரையேஷ்
yooe	ரையோ
yue	ரையோ
yuee	ரையே
yuii	யூனி
yuu	ரையூதி
yuue	ரையோ
yuuee	ரையோ
yooth	யூத்தி
youth	யூத்து
ioore	யரூர்
iuri	யுரி
uree	உரை
urii	ஊரித்
uuree	உரை
yoore	யரர்தி
yoori	யூரி
youri	யூரி
yure	யுரே
yuri	யுரி
yuuri	யூரி
uric	ஊரிச்
yoorik	யூரிக்
yourik	யூரிக்
yellaam	எல்லம்
yoagaththin	யோகத்தின்
yoakaththin	யோகத்தின்
yookaththin	யூகத்தின்
yoagan	யோகன்
yoakan	யோகன்
yogan	யோகன்
yookan	யூசன்
yoagam	யோகம்
yoakam	யோகம்
yogam	யோகம்
yookam	யூகம்
yoakkiyamaana	யாக்சியமான
yokkiyamaana	யாக்சியமான
yookkiyamaana	யூக்சியமான
yoasanaigal	யோசனைகள்
yoasanaikal	யோசனைகள்
yoosanaikal	யூசசையா்
yoasanaikku	யோசனைக்கு
yoosanaikku	யூசஞைக்கு
rasa	ரோசியா
railgal	இரில்கள்
railhal	இரைல்
railkal	இரில்கள்
raiylgal	இரைக்கள்
raiylhal	இரையல்
raiylkal	இரைக்கள்
rayilgal	ரயில்கள்
rayilkal	ரயில்கள்
rashyan	ரிஷண்
rassian	ரசியன்
russian	ிசுசன்
ragman	ராகம்
rahmaan	இராமான்
rahman	ராமுின்
rehhman	ரீமன்
rehmaan	ரீமான்
rehman	ரிமன்
rehmann	ரீமனின்
raajaraajanin	ராஜராஜினின்
rajarajanin	ரரஜஜிின்
raajaraajan	ராஜராஜன்
rajarajan	ராஜரசன்
raanuva	ராயுவோ
raanuvath	இராணுவத்
raanuvaththirku	இராணுவத்திற்கு
raanuvaththil	இராணுவத்தில்
raanuvaththai	இராணுவத்தை
raamachchanthiran	ராமச்சந்தினர்
ramachandran	ரமாச்்நரத்தன்
ramachchandiran	ரமச்சா்தினரின்
ramachchandran	ரமச்சந்தின்
raam	ணை
raamaa	இராம
ram	ணை
rama	நராம்
raamaayanam	இராமாயம்
raamayanam	ராமாயமம்
ramayanam	இரமணயம்
ring	னிரு
ringk	ரிங்க்
rink	ரிங்க்
rings	ரிங்ஸ்
reserve	ரேச்வர்
risarv	ரிசுவர்
reeshi	ரிஷ்ணி
reesi	ரிசை
reesii	ரிஷ்யை
reshii	ரிஷ்ணை
resii	ரிஷ்யை
riishi	ரிஷ்ணி
riisi	ரிசி
riisii	ரிசி
rishi	ரிஷ்ணி
rishii	ரிஷ்ணை
risi	ரிசி
risii	ரிசி
rishigal	ரிஷ்கள்
rishikal	ரிஷ்கள்
reethiyilum	ரீதியிலும்
reethiyil	ரீதியில்
roopavaahini	ரோபாவதினி
roopavahini	ரோபவதினி
rupavahini	ருபவதினி
rupavauhini	ருபவதின்
racklaa	ராக்கியா
raeklaa	ராய்கள
rekla	ரெக்
raench	ரெனிஷ்
raenjch	ரெஞ்சு
radaar	ராடார்
radar	டரியர்
radarr	டரியர்
raedaar	ராய்டார்
redar	டிராத்
reedar	ரிடர்
raendam	ரண்டும்
raentam	ரண்டும்
random	அணிதும்
rendaam	ரிணாட்ம்
raaend	ரியன்டு
raand	ரணய்டு
rand	ணியு
reend	ரியந்து
rend	ிருட்
roadu	ரோடு
roam	ரைசும்
rome	ரைம்
roavar	யோரவி
roaver	ரோவர்
roawer	ருவே்
rooaver	ரூவர்
roovar	ரூவர்
roover	ருவே்
roower	ருவே்
rovar	ராவி
rover	ருவே்
rowar	ராவிர்
rower	ருவே்
lachith	அச்சித்
lacith	அசித்த்
lasith	லசித்த்
latchanam	ஆட்சநாம்
lakchhami	லக்சமி
lakshmee	நாக்சீமி
lakshmi	லா்சி
laksmee	லாந்தீ
laksmii	லா்சிமி
laqchhami	லா்சமி
laqsmee	லாந்தி
laqsmi	லா்சி
lakshimiyin	லா்சிமியின்
lakshumiyin	லாக்சுமியின்
latchumiyin	இள்சுமியின்
latsumiyin	தால்சுமியின்
laddu	லட்டு
lattu	இர்டு
landanil	லண்டானில்
londonil	லான்டினில்
laththeen	லத்தின்
latiin	ளிடின்
latiina	நாதிடி
latin	ளிடன்
lattiin	ளாட்டின்
letan	லியடன்
leten	லியடன்
letiin	ளிட்டின்
letin	ளிடின்
lalithaa	நாலித்த
laagic	லிச்
laajic	லாசிச்
logic	ளோிக்
laabaththai	லாபத்தை
laapaththai	லாபத்தை
linda	நில்டு
lindaa	நித்தா
linaks	நிலா்்
linux	ினுச்
livarpool	விரபெஸ்லோ
livarpuul	விரப்பூலு
liverpool	விரெஸ்போல்
liverpul	விழெய்புப்
liwerpool	விரெஸ்லோப்
leaguein	லீயானும்
leakin	ளியிங்
leakkin	லிக்கின்
leekin	ிியங்
loodhana	லூதன்
loodhiaanaa	உதோயான
loodhiana	லூதியான
ludhana	நூத்தா
ludheeana	லூதியான
ludheena	லூதியான
ludhiaanaa	உதியானா
ludhiana	உதியான
ludhiiana	உதியோலான
luudheeana	லூதீயான
luudhiana	உூதியான
luutiyana	உூடியான
lakshmi	லா்சி
letchumi	லெல்சும்
letshumi	லெல்சுமி
laechana	லெய்சான்
laesaana	லேசான
laenaa	யணியா
laneaa	நாய்லா
loagiyaa	லோகிய
loakiyaa	லோகியா
vaguththa	வகுத்த
vakuththa	வகுத்த
vaguththadhu	வகுத்தது
vaguththathu	வகுத்தது
vakuththathu	வகுத்தது
vaguththal	வகுத்தல்
vakuththal	வகுத்தல்
vaguththaar	வகுத்தார்
vakuththaar	வகுத்தார்
vaguththaal	வகுத்தால்
vakuththaal	வகுத்தால்
vakkeel	வீக்கேல்
vangadhaesaththin	வங்கேதததத்தின்
vangathaesaththin	வங்கதேசத்தின்
vangkadhaesaththin	வங்கேததேசன்
vangadhaesam	வங்கதேசம்
vangathaesam	வங்கதேசம்
vangkadhaesam	வங்கதேசம்
vasiththanar	வசித்தனர்
vanchi	வனிஷ்
vanji	வனிஷ்
vansi	வனிஷ்
vadanaattil	வடனாட்டில்
vadapuram	வடறுப்
vadamaerkil	வடமிழ்கில்
vatamaerkil	வடமிற்சில்
vadikaal	வடிகளால்
vadikal	வடிகள்
vadikkappatta	வடிக்கப்பட்ட
vadikkappattathu	வடிக்கப்பட்டது
vattiyai	வட்டியை
vanigarkalin	வணிகர்களின்
vanikarkalin	வணிகர்களின்
vanigarkalum	வணிகர்களும்
vanikarkalum	வணிகர்களும்
vanigargal	வணிகர்கள்
vanigarkal	வணிகர்கள்
vanikarkal	வணிகர்கள்
vadham	வனதும்
vatham	வனதும்
wadham	வனதும்
watham	வனத்
vandhanar	நாந்தபர்
vanthanar	நந்தவர்
vanththanar	நந்திரன்
vanthiyathevan	வந்தியத்தவன்
vanthiyaththaevan	வந்தியதுத்தான்
vanthiyaththevan	வந்தியத்துவன்
vanpunarvu	வன்னுப்பது
vamsaththil	வம்சத்தில்
vamsaththai	வம்சத்தை
vayathin	வயிின்
varadhan	வரணத்
varathan	வரணத்
varadham	வரதம்
varatham	வரத்தும்
varappoagum	வரப்போகும்
varappoakum	வரப்போகும்
varalaam	வரணம்
varalaattruch	வராாற்சுது
varalaattruth	வளராற்துத்
varavaal	வரவல்
varavirukkum	வரிவருக்கும்
varaaga	வராய்
varaaka	நாரா
varaga	வரக்
vari	வரி
varigalai	வரிகளை
varikalai	வரிகளை
varigal	வரிகள்
varikal	வரிகள்
variyil	வரியில்
variyai	வரியை
varudi	வருடி
varuvaai	வருவாய்
varuvaay	வருவாய்
varuvaaith	வறுவாய்த்
varuvaayth	வறுவாய்
varuvaith	வறுவைத்
vruvaayth	விருவாத்
varaikooda	வரைகூடோ
varaikoodaa	வரைகோடா
valasai	வசரை
valimaiyaana	வழிமையான
vallarasu	வள்ளரசு
valaththaiyum	வளத்தையும்
valaigutaa	வழைகுட
valaikudaa	வழைகுடா
valaikutaa	வழைகுடா
valaigutaavil	வழைகுடாவில்
valaikudaavil	வழைகுடாவில்
valaikutaavil	வழைகுடுவில்
valakku	வழக்கு
vazhakku	வழக்கு
vicarikka	விசாரிக்க
visaarikka	விசாரிக்க
visarikka	விசரிக்க
valakkugalil	வழக்குகளில்
valakkukalil	வழக்குகளில்
vazhakkukalil	வழக்குகளில்
valakkugalukku	வழக்குகளுக்கு
valakkukalukku	வழக்குகளுக்கு
vazhakkukalukku	வழக்குகளுக்கு
valakkugalum	வழக்குகளும்
valakkukalum	வழக்குகளும்
vazhakkukalum	வழக்குகளும்
valakkugalaiyum	வழக்குகளையும்
valakkukalaiyum	வழக்குகளையும்
vazhakkukalaiyum	வழக்குகளையும்
valakkup	வழக்குப்
vazhakkup	வழக்குப்
valakkurai	வழக்குறை
vazhakkurai	வழக்குறை
valangappadaamal	வழங்கப்படாமல்
vazhangappadaamal	வழங்கப்படாமல்
vazhanggappadaamal	வழங்கப்படாமம்
valangappaduvathu	வழங்கப்படுவது
valangkappaduvathu	வழங்கப்படுவது
vazhanggappaduvathu	வழங்கப்படுவது
vazhangkappaduvathu	வழங்கப்படுவது
valangal	வணல்கள்
valangkal	வழங்கள்
vazhangkal	வழங்கள்
valangkunar	வழங்குகன்
valankunar	வணக்குந்த
vazhanggunar	வழங்குகன்
vazhangkunar	வழங்குகன்
vazhankunar	வழங்குகன்
valangkuvathutan	வழங்குவதுடன்
valanguvathudan	வழங்குவதுடன்
vazhangkuvathudan	வழங்குவதுடன்
vazhanguvathudan	வழங்குவதுடன்
valangkuvathai	வழங்குவதை
valanguvathai	வழங்குவதை
vazhangkuvathai	வழங்குவதை
vazhanguvathai	வழங்குவதை
valigaattu	வழிகாடுது
valikaattu	வழிகாட்டு
vazhigaattu	வழிகாட்டு
vazhikaattu	வழிகாட்டு
valikaattum	வழிகாட்டும்
vazhigaattum	வழிகாட்டும்
vazhikaattum	வழிகாட்டும்
valiththoanral	வழித்தொன்றால்
vazhiththoantral	வழித்தொன்றால்
valiththoanralkal	வழித்தொன்ற்கள்
vazhithoantralgal	வழினோத்தொள்ளா்
vazhiththoantralgal	வழித்தொன்றால்கள்
valinadaththi	வளினடுத்தி
vazhinadaththi	வழிநகத்தி
valinadaththinaar	வழிநடடத்தினார்
vazhinadaththinaar	வழிநகத்தினர்
valinadaththum	வழினடுத்தம்
vazhinadaththum	வழிநடுத்தம்
valukku	வழுக்கு
vazhukku	வழுக்கு
vavuniya	வனுவிய
vavuniyaa	வுனியா
vaagananggalin	வாகங்களின்
vaaganangkalin	வாகங்களின்
vaakanangkalin	வாகங்களின்
vaagananggalukku	வாகஙங்களுக்கு
vaaganangkalukku	வாகஙங்களுக்கு
vaakanangkalukku	வாகஙங்களுக்கு
vaaganagkalaik	வாகங்களைக்
vaagananggalaik	வாகஙங்களைக்
vaakanangkalaik	வாகங்களைக்
vaagananggalaiyum	வாகங்களையும்
vaaganangkalaiyum	வாகங்களையும்
vaakanangkalaiyum	வாகங்களையும்
vaaganaththai	வாகநதத்தை
vaakanaththai	வாகநதத்தை
vaaganamaaga	வாகணமாக
vaaganamaga	வாகணமம்
vaaganamaka	வாகணமம்
vaakanamaaka	வாகநாமக
vaakanamaga	வாகணமாக
vaakanamaka	வாகணமாக
vaaganam	வாகமும்
vaakanam	வாகமும்
paesalaam	பேசலம்
pecalam	பெயலம்
pesalaam	பெளசம்
vaangappadum	வாங்கப்படும்
vaanggappadum	வாங்கப்படும்
vaangkappadum	வாங்கப்படும்
vaangappattu	வாங்கப்பட்டு
vaanggappattu	வாங்கப்பட்டு
vaangkappattu	வாங்கப்பட்டு
vaangavum	வாங்கவும்
vaanggavum	வாங்கவும்
vaangguthal	வாங்குதல்
vaangkuthal	வாங்குதல்
boadhum	பூதும்
poadhum	பூதும்
poathum	பூதும்
vaanggum	விங்கும்
vaangkum	விங்கும்
vaangum	விங்கும்
vaasippathil	வாசிப்பதில்
vaasippathu	வாசிப்பது
vaasippavar	வாசிப்பார்
vaadiya	வாயிட
vaater	வெற்றி
vatar	விடர்
vater	வெற்
vaterr	வெட்டுர்
veter	விட்டு
vouter	வுட்்
waatar	வாத்
waater	விட்டு
waeter	விட்டு
watar	விடர்
watarr	வடிர்
water	வெட்
waterr	வெட்டர்
weter	விட்டு
weterr	விட்டர்
woutar	ஓவுட்
wouter	வுட்டர்
wouuter	வுட்டர்
vaattara	வாட்டுர
vaatters	வாட்டிர்
waters	வெட்ரஸ்
vaathittathu	வாயித்து
vaathittaar	வாதிட்டார்
vaathittu	வாய்துத்
vaayilaagavum	வாயியாகவும்
vaayilaakavum	வாயிலாகவும்
vaalin	வினில்
vaazhvathu	வாழ்வது
vaalvar	வார்வி்
vaazhvar	வார்வு்
vaazhvilirundthu	வாழ்விலிந்துந்து
vaazhvilirunththu	வாழ்விலிருந்து
vaazhvilirunthu	வாழ்விலிருந்து
vaalvu	வுர்வு
vaazhvu	விழுவு
vaalvum	விழும்
vaazhvae	வாழ்வே
vaazhvum	விழும்
vaasthu	விஸ்து
vigaaraigal	விகாரைகள்
viharaigal	வியகளைப்
vikaaraigal	விகாரைகள்
vikiraman	விகிரமான்
vikkiraman	விகிரகமான்
vikraman	விகரமான்
vichaariththa	விசாரித்த
visaariththa	விசாரித்த
vichaeshamaana	விஷசாமான
visaeshamaana	விஷசாமன்
vichai	விசை
visai	வியசி
vichaikalai	விசைகளை
visaigalai	விசைகளை
visaikalai	விசைகளை
visaiyin	வியையின்
visaiyudan	வியசயுந்தான்
vinchi	வின்சி
vinjchi	விஞ்சி
vinchiya	வின்சிய
vinjchiya	விஞ்சிய
vidayanggalai	விடையங்களை
vidayangkalai	விடையங்களை
vitayangkalai	விடையங்களை
vidayaththai	விடையத்தை
vitayaththai	விடாயத்தை
vidayamaaka	விடயமாக
vidayanmaaga	விடயானமாக
vitayamaaga	விடடயமாக
vidayam	வியடம்
vitayam	வியடம்
vittaal	விட்டால்
vittaen	விட்டின்
vidhikka	விதிக்கா
vithikka	விதிக்கா
vithikkavillai	விதிக்கவில்லை
vidhdhiyaa	வித்திய
vidhya	விதியா
viththiyaa	வித்தியா
viththiyaachaththil	வித்தியாயத்தில்
viththiyaasaththil	வித்தியாயத்தில்
viththiyaachaththai	வித்தியாசத்தை
viththiyaasaththai	வித்தியாசத்தை
viththiyaachap	வித்தியாசப்
viththiyaasap	வித்தியாசப்
viththiyaaamaaga	வித்தியாகவ
viththiyaachamaaka	வித்தியாசமாக
viththiyaasamaaga	வித்தியாசமாக
viththiyaasam	வித்தியாசம்
vineedh	வினித்
vineeth	வினித்
vibaththin	விபத்தின்
vipaththin	விபத்தின்
vibaththil	விபத்தில்
vipaththil	விபத்தில்
vimarsiththaar	விமர்சித்தார்
vimarsiththullaar	விமர்சித்துள்ளார்
vimaanangalin	விமானங்களின்
vimaananggalin	விமானங்களின்
vimaanangalum	விமானங்களும்
vimaananggalum	விமானங்களும்
vimaananggal	விமானங்கள்
vimaanankal	விமானங்கள்
viyantha	வியந்த
viyanththa	வியந்த
viyanththu	வியந்து
viyanthu	வியந்து
viyaabaarigalin	வியாபாரிகளின்
viyaapaarigalin	வியாபாரிகளின்
viratha	வரித
virathangal	விரதங்கள்
virathanggal	விரதங்கள்
virathangkal	விரதங்கள்
viradham	வரிதம்
viratham	விரதும்
virivaaga	விரிவாக
virivaagath	விரிவாதது
virivuraigal	விரிவுறைகள்
virumbaatha	விரும்பாத
virumbaathu	விரும்பது
virpathu	விற்பது
vitrtrathu	விற்றுத்
vittradhu	விற்றுது
vittrathu	விற்றுது
vitrtral	விற்றுள்
vittral	விற்று
vitrtraar	விற்று
vittraar	விற்று
viliam	வியிலம்
viliiam	விலியம்
viliyam	வியியம்
villiam	வில்லைம்
villiyam	வில்லியம்
wiliam	விலியம்
wiliiam	விலியம்
wiliyam	விலியம்
william	வில்லியம்
villiams	வில்லியம்
villiyams	வில்லியம்
wiliams	விலியம்
williams	வில்லியம்
villaigal	வில்லைகள்
villaikal	விலைகள்
villaiyum	விளையும்
vilaadimir	விளாடிமிர்
viladimir	விளடிரித்
vlaadimir	விளாட்டிரி
vlademar	விளடமர்
vlademer	விளடமீர்
vladimir	விளடிமிர்
vladimirr	விளடிமிர்
vladymyr	விளட்யிர்
wlademer	விலடமீர்
wladimir	விளடிமிர்
wladimirr	விளடிமிர்
wladymyr	நிலாட்டிர்
vilimbugal	விளிமுக்கள்
vilimbukal	விளிமுக்கள்
vilimpugal	விளிம்புகள்
vilimpukal	விளிம்புகள்
vilaiyaada	விளையாட
vilaiyaadappadum	விளையாடப்படும்
vilaiyaadavillai	விளையாட்விலைல்
vilaiyaadudhal	விளையாடுத்
vilaiyaaduthal	விளையாடுத்
vilaiyaattaagavum	விளையாட்டாகும்
vilaiyaattaakavum	விளையாட்டாகவும்
villupuram	விளுப்புறம்
viluppuram	விழுப்புறம்
vilupuram	விளுபுரம்
vizhuppuram	விழுப்புறம்
vivariththaar	விவரித்தார்
vivariththullaar	விவரித்துள்ளார்
vishaagaa	விசாக
vishaakaa	விசாக
vishaka	விசாக
veesappatta	வீசப்பட்ட
veechith	வீச்த்
veesith	விஷ்த்
veechina	வினியா
veesina	விஷின்
veechuthal	வீசுதல்
veesuthal	விசுதல்
veechuvatharku	சீவுவதற்கு
veesuvatharku	சீவுவதற்கு
veetirkuch	வீட்டிருச்
veettirguch	வீட்டிருக்சு
veettirkuch	வீட்டிருக்கு
veettilae	வீட்டிலே
veeraraaga	வரராக்
veeraraaka	வரராக்
veetrirukkum	வீர்றிகுக்கும்
veetrtrirukkum	வீற்றிருக்கும்
veettrirukkum	வீற்றிருக்கும்
veel	வில்
veil	வியில்
viil	வில்
weiil	வியில்
weil	வியில்
wheel	வில்
veelchchikkum	வீழ்ச்சிக்கும்
veerzhchchikkum	விர்ச்சிக்கும்
veezhchchikkum	வீழ்ச்சிக்கும்
veelchchiyin	விழ்ச்சியின்
veezhchchiyin	விழ்ச்சியின்
veelchchiyilirunththu	வீழ்சியிலியந்து
veezhchchiyilirunththu	வீழ்சியிலியிந்து
veezhchchiyilirunthu	வீழ்சியிலியிந்து
veelchchiyum	விழ்ச்சியும்
veezhchchiyum	விழ்ச்சியும்
veelnththathu	வெழ்ந்தது
veezhnthathu	வீழ்ந்தது
vedikkach	வீடிக்கச்
veppaththin	வெப்பதின்
veppaththaith	வெப்பத்தைத்
veppaththaiyum	வெப்பதியையும்
veppap	விப்பட்
veppamaaga	வெப்பாமாக
veppamaaka	வெப்பாமாக
veruththa	வெறுத்த
veruththaar	விருத்தார்
verumai	வுரமை
verumaiyaaga	வெருமையாக
verumaiyaaka	வெருமையாக
vetrikaramaaka	வெற்றிகமாகவா
vetrtrigaramaaga	வெற்றிகராகவ
vetrtrikaramaaka	வெற்றிக்கமாக
vetrida	விறிடு
vetrtrida	விற்றுட
vetrtrita	விற்றுட்
vettrida	விற்றிய
vetridaththil	வெறிடுததிதில்
vetrtridaththil	வெற்றிடத்தில்
vetrtritaththil	வெற்றிட்டத்தில்
vettridaththil	வெற்றிடத்தில்
vetrtridaththai	வெற்றிட்டதைதை
vetrtritaththai	வெற்றிட்டத்தை
vettridaththai	வெற்றிடத்தை
vetrtridam	விற்றிடம்
vetrtritam	விற்றிடம்
vettridam	விற்றிடம்
vaelsh	வெழ்ச்
vels	வெல்ஸ்
velsh	வெல்ஸ்
veyls	வெயில்ல்
weils	வில்ல்
wells	வெல்ல்
wellsh	வெல்ல்
wels	வில்ல்
welsh	வெல்ஸ்
weyls	வெயில்ல்
weylsh	வெய்ஸ்லோ
velip	விலைப்
velippadaiyaanadhu	வெளிப்படையானது
velippadaiyaanathu	வெளிப்படையானது
velippuram	வெளிப்புறம்
veliyidappattana	வெளியிடப்பட்டன
vaegam	விகம்
vaekam	விகம்
vaedhak	வீதக்
vaethak	விது
vedeec	வீடியு
vedic	விடிக்
vediic	விடிசில்
vedik	விடிக்
vediq	விடிக்
veedeec	வீடியு
veedic	வீடிச்
veedik	வீடிக்
veetak	வியகு
wedeec	விடியு
wedic	விடிசு
wedik	விடிக்
vaedhangkalil	வேதங்களில்
vaethangalil	வேதங்களில்
vaethangkalil	வேதங்களில்
vaedhaththin	வேதத்தின்
vaethaththin	வேதத்தின்
vaedhaththil	வேதத்தில்
vaethaththil	வேதத்தில்
vaedhaththai	வேதத்தை
vaethaththai	வேதத்தை
vaedhaalam	வாதாலம்
vaethaalam	வாதாளம்
vedhaalam	வீதளும்
vaedhi	விதி
vaethi	விதி
vedhi	விதி
vaedhipporulkal	வேதிப்பொருள்கள்
vaethipporutkal	வேதிப்பொருக்க
vaedhiyar	வீதியர்
vaethiyar	விதியர்
vaenae	வெணை
vanae	வனே
vae	வை
vaei	வியை
vaey	விய்
vai	வை
vay	யவி
veey	வியு
wae	வை
waee	வியே
wai	வை
way	யவு
vaerudan	வருடு்
vaerutan	விருடன்
vaerldu	வெருத்து
world	வருத்
vaeraaga	வராயும்
vaeraaka	வராயும்
vaeroru	வருரு
vaeroruvan	வறுருண்
vaeroruvar	வறுருர்
vaelunaachchiyaar	வேழுக்கியாவிர்
velunachiyar	வெனுளசியர்
vaelai	வெயுள்
vaelaigalin	வேலைகளின்
vaelaikalin	வேலைகளின்
vaelaigalum	வேலைகளும்
vaelaikalum	வேலைகளும்
vaelaigalai	வேலைகளை
vaelaikalai	வேலைகளை
vaelaik	வெயுக்
vaelaikkaana	வேலைக்கான
vaelaikkup	வீழைக்குப்
vaelaikkum	வேழைக்கும்
vaelaich	வெயிச்சு
paarppavar	பாற்ப்பவர்
paarththu	பரித்து
parppavar	பற்ப்பவர்
vaelaiyaaga	வெளையாக
vaelaiyaaka	வெளையாக
vealaiyaaka	வெளையாக
vaelaiyin	வெளையின்
vealaiyin	விலையின்
vaelaiyil	வேலையில்
vealaiyil	வெயலையில்
vaelaiyaiyum	வேளையையும்
vealaiyaiyum	வேலையையும்
vai	வை
vaiguntarin	வைகுந்தனர்
vaikundarin	வைக்குண்டின்
vaiguntar	வைகுந்தார்
vaikundar	வைகுந்தார்
vaiththiyanaatha	வைத்தியானத
vaiththiyanaathan	வைத்தியனானத்
vaibavam	வைபவம்
vaipavam	வைபவம்
volga	வொழ்க
volgaa	வொக்கா
voolga	வூல்
voolka	வூல்க
vooulga	வூல்
voulga	வூல்
vouulga	வூல்
wolga	வொழ்க
wolgaa	வொல்கா
woolga	வூல்
woolgaa	வுக்கா
woulga	வூல்
shaam	ச்ம்
sham	ச்ம்
shaavai	சாவை
shahvai	ச்வதை
shavai	சைவ
escotch	இச்சோட்
scotch	சுட்சி
skaatch	ஸ்டாச்
skoch	ஸ்கோஷ்
skotch	ஸ்டுச்
sqoch	ஸ்கோஷ்
sqotch	ஸ்டுச்
scotlaanththin	ஸ்கோட்லாந்தின்
scotlandin	ஸ்டுடாலிந்தின்
skaatlaandhin	ஸ்காலாந்தின்
sthaabaga	ஸ்டாபா
sthaapaga	தோபாதாக
shreenivaachan	சிரினாவிஷா்
sreenivaasan	ஸ்ரீனாவியன்
srinivaachan	ஸ்ரினியாவாசன்
srinivaasan	ஸ்ரினிவாசன்
srinivasan	ஸ்ரினீசாவன்
shreerangkaththil	திரேகாந்தத்தில்
sreerankaththil	ஸ்ரீரக்கந்தில்
srirangaththil	ஸ்ரீரக்கந்ததில்
sriranggaththil	ஸ்ரீரக்கந்ததில்
srirangkaththil	ஸ்ரீரக்கந்ததில்
hangaran	ஹங்கரன்
hangarian	ஹங்கரியன்
hankeeriyan	ஹங்கீரியன்
hungaran	குரங்கான்
hungarian	குங்காரின்
huungarian	சுங்கரியன்
hanggaeriyil	ஆங்கிறேயில்
hankeariyil	ஆங்கிறேயில்
hungaeriyil	குங்கேறியில்
hungaryil	ஹுங்காரில்
hungaryyil	ஹுங்காயில்
harijan	அரிஜன்
paattar	பட்டுர்
paatter	பாட்டிர்
pattar	பட்டுர்
potter	புட்டிர்
haaris	ஹிரிஸ்
hairis	ஹிரிஸ்
hairiss	ஹாரிஸ்தி
hares	ஹரெஷ்
haris	சரித்
hariz	ஹரில்
harres	ஹரெஸ்டி
harrij	ஹரிஸ்
harris	சரித்தி
harriss	ஹரிஸ்கி
harriz	ஹரிஸ்
heriss	ஹெரிஸ்
hael	ஹில்
hel	ைசில்
hell	லெயில்
haidroa	ஹெய்ரோ
haitrao	யாதிரா
hydro	திராட்
haithar	ஹைத்தர்
hyder	டியர்
