faarm	பரர்
farm	பர்
form	ரூர்
hpaarm	னார்
face	போஸ்
hpaes	பீட்
pace	பே
paes	பேஸ்
phase	புசே
aeathimuka	ஏதிருக்க
aiathimuka	அரைதுக்க
ayiathimuka	அயியதுது
agaththi	அகத்தி
akaththi	அகத்தி
agaththikkeerai	அகத்திக்கேரி
akaththikkeerai	அகத்திகரேக்கை
agamadhabaath	அகுமதாதத்
agamathaabaath	அகமதாாதத்
ahamadabad	அமதாாபட
ahemadaabad	அமேசதாபட்ட
ahmadabad	அம்தாாப்
ahmedabad	அமீபடாத்
akamatapat	அகம்படத்
agamadhabaatthil	அகமதாாத்தில்
agamathaabaaththil	அகமதாாத்தில்
ahmadabadil	அம்மடாவதலல்
ahmedabadil	அமீதாடடில்
ahmedabadthil	அம்யகோதடத்தில்
agazhaaivil	அகழாய்வில்
agazhaayvil	அகழாய்வில்
akalvaaivil	அகழ்வாய்வில்
akazhaayvil	அகழாய்வில்
akazhvaaivil	அகழ்வாய்வில்
ahimsai	அமைச்ச
akimsai	கட்சிை
angkeegariththu	அங்கீகரித்து
angkeekariththu	அங்கீகரித்து
angkeegariththullathu	அங்கீகரித்துள்ளது
angkeekariththullathu	அங்கீகரித்துள்ளது
angkeegaarangkal	அங்கீகர்களின்
angkeekaarangkal	அங்கீகர்களின்
angkeegaaraththaip	அங்கீகராதத்தி
angkeekaaraththaip	அங்கீகராத்ததி
asaiyaa	சனையா
ashokan	அசோகன்
asokan	அசோகன்
achoakaa	அசோக்
ashok	அசோக்
ashoka	அசோக
ashokaa	அசோக்
asok	சொக்
asoka	அசோக்
asokaa	அசோக்கா
asook	சபோக்
asooka	அசோக்
asookaa	அசோகர்
asoq	அசோக்
asoqa	அசோக்
asoqaa	அசோக்
adakki	தடக்கி
adakkik	டடக்கி
adainkiya	அடைஞ்கிய
adangiya	அடங்கிய
adankiya	அடங்கிய
adanggiyadhu	அடங்கியது
adanggiyathu	அடங்கியது
adangiyadhu	அடங்கியது
adangiyathu	அடங்கியது
adankiyathu	அடங்கியது
adangiyulla	அடங்கியுள்ள
adangkiyulla	அடங்கியுள்ள
adankiyuzhzha	அடங்கியுள்ள
pidiththu	பிடித்து
pitittu	பிடித்து
aada	ஏதற்
aadaa	தாற
ada	தட
adaa	தாற
manadhil	மனதில்
manathil	மனதில்
manatil	மணதி
adigalum	அடிகளும்
adihalum	அதிதாலும்
adikalum	அடிகளும்
adigalaiyum	அடிகளையும்
adigalayum	அடிகளையும்
adikalaiyum	அடிகளையும்
adikalayum	அடிகளையும்
adikkadi	அடிக்கடி
adikkadik	அடிக்கடிக்
adikku	அடிக்கு
adith	தடித்து
adiyilirundhu	அடியிலிருந்து
adiyilirunthu	அடியிலிருந்து
adiyilum	எடியிலும்
adiyum	தடியும்
atiyum	திய்யும்
adiyai	அடியை
atiyai	தியாய
aduththum	அடுத்தும்
aduthum	அடுத்தும்
adutthum	அடுத்தும்
adaithal	அடைத்தால்
ataithal	அடைத்தல்
attooliyangalum	அட்டோலிலாயினும்
attoozhiyangalum	அட்டோலிலாயிக்
attoozhiyanggalum	அட்டோலி்சாயிகளும்
andar	ஆண்டார்
antar	ஆண்டார்
under	ர்டேன்
annan	மன்னன்
adhanadhan	ததனதன்
adhanathan	ததனதன்
athanathan	அதனதன்
adhanudan	தனத்தன்
athanudan	அதனுடன்
adhaavadhu	அதாவது
adhavadhu	அதவது
athaavathu	அதாவது
athavathu	அதரவு
adhigappadiyaaga	அதிகப்படியாக
athigappadiyaaga	அதிகப்படியாக
athikappatiyaaka	அதிகப்படியாக
adhikamaanathu	அதிகமானது
athigamaanathu	அதிகமானது
athikamaanathu	அதிகமானது
adhidhi	ததிதி
adiiti	அடியிட்டி
adiitii	அடியிடி
adiittii	அடித்தி
aditi	அடித்தி
aditii	அடிடிடி
aditti	அடித்தி
athithi	அதிதி
atiti	அடித்தி
adhiradi	தரிட
athiradi	தரிடி
adhirvu	ததிவு
athirvu	அதிர்வு
adhirvukaly	அதிர்வுகளை
athirvukalai	அதிர்வுகளை
athirvukalay	அதிர்வுகளை
athirvugal	அதிர்வுகள்
athirvukal	அதிர்வுகள்
adhilum	திிலும்
athillum	திில்லும்
athilum	திிலும்
adhilaeyae	தளியேலே
adhileye	தளிலேயே
athilaeyae	தளியேலே
athileye	தளிலேயே
adheedhamaana	அதிதமான
adhidhamana	அதிதமான
atheethamaana	அத்தமான
athithamana	அதிதமணன
adhaepoal	தேோபோல்
ateepool	டெட்போல்
atepol	அட்போல்
athaepool	தேபோர்
aththiyaayangalil	அத்தியா்களையில்
aththiyaayangkalil	அத்தியா்களைகள்
aththiyaayangalai	அத்தியாய்களை
aththiyaayangkalai	அத்தியாய்களை
aththiyaayangal	அத்தியாயங்கள்
aththiyaayangkal	அத்தியா்களைக்
aththiyaayaththin	அத்தியாத்தினன்
aththiyaayaththil	அத்தியாத்தில்
aththiyaayam	அத்தியாயம்
andhak	நந்தக்
andhakh	நந்தக்
anthak	நந்தக்
andhandha	அந்தந்த
anthantha	அந்தந்த
andhoni	அந்தோணி
anthoni	அந்தோணி
anthony	அந்தோணி
antony	அந்தோணி
ananrtham	நனந்தது
anarththam	நரர்த்தா்
aneeta	அநீந்த
aneetaa	அநிநாட்ட
aniita	அரினாட்டா
aniitaa	அனிய
anita	அடின்
anitaa	தினிய
anitha	நிித்த
anithaa	தனித்தா
anubama	அனுபமா
anubamaa	அனுபாமா
anupama	அனுபமா
anupamaa	அனுபமா
anubavika	அனுபவிக
anubavikka	அனுபவிக்க
anupavikka	அனுபவிக்க
anuppia	அனுப்பிய
anuppiya	அனுப்பிய
anuppiyathu	அனுப்பியது
anuraadhapuraththil	அனுராபாரத்தில்
anuraathapuraththil	அனுராபாரத்தில்
anuradhapuraththil	அனுராதப்படத்தில்
anurathapuraththil	அனுராபத்தத்தில்
anuraathapuram	அனுராபுறதார்
anuradhapuram	அனுரத்துறார்
anurathapuram	அனுரத்துறார்
anniya	அன்னிய
anbai	அன்பை
anbaip	பண்பைப்
anpaip	பண்பைப்
anbaiyum	பன்பையும்
andri	அன்றி
antri	அன்றி
andriravu	அன்றிறவு
antriravu	அற்றிவவு
abinaya	பரினாய
apinaya	பரினையா
abudhabiyil	அபுபடியில்
abuthaabiyil	அபுபாயிதில்
abul	பருள்
aboorvamaana	அபோர்வமான
aburvamaana	அபுர்வமான
apoorvamaana	அபுபர்வமான
appagudhi	அப்பகுதி
appaguthi	அப்பகுதி
appakuthi	அப்பகுதி
appaguthigalil	அப்பகுதிகளில்
appaguthikalil	அப்பகுதிகளில்
appakuthikalil	அப்பகுதிகளில்
appaguthikku	அப்பகுதிக்கு
appakuthikku	அப்பகுதிக்கு
appaguthiyin	அப்பகுதியின்
appakuthiin	அப்பகுதியின்
appakuthiyin	அப்பகுதியின்
appadaththil	அப்படத்தில்
appadatthil	அப்படத்தில்
appadaththai	அப்படத்தை
appadatthai	அப்படத்தை
appadiyaanaal	அப்படியாலான்
appaadal	பப்பாடல்
appaatal	பப்பாட்டால்
apengal	பபெண்கள்
apenkal	அபெங்கில்
appenkal	பப்பெண்கள்
appoluthu	அப்பொழுது
appozhudhu	அப்பொழுது
appozhuthu	அப்பொழுது
americar	அமெரிக்கர்
amerikkar	அமெரிக்க
amerikkargalukku	அமெரிக்காற்களுக்கு
amerikkarkalukku	அமெரிக்கார்களுக்கு
amerikkargal	அமெரிக்கார்கள்
amerikkarkal	அமெரிக்கார்கள்
amaerikka	அமேரிக்க
amarica	அமிரிக்க
amaricaa	அமிராகா
amarika	அமரிக
amarikaa	அமரிகா
america	அமெரிக்க
americaa	அமெரிக்க
amerika	அமெரிக்க
amerikaa	அவெரிக்க
amerikka	அமெரிக்க
ameriqa	அமெரிக்க
ameriqaa	அமெரிக்க
americaavirku	அமெரிக்காவிற்கு
americavirkku	அமெரிக்காவிற்கு
americavirku	அமெரிக்காவிற்கு
amerikkaavirku	அமெரிக்காவிற்கு
americaavil	அமெரிக்காவில்
americavil	அமெரிக்காவில்
amerikkaavil	அமெரிக்காவில்
americaavukku	அமெரிக்காவுக்கு
americavukku	அமெரிக்குவாகு
amerikkaavukku	அமெரிக்காவுக்கு
americaavai	அமெரிக்காவை
americavai	அமெரிக்காை
amerikkaavai	அமெரிக்காவை
amaichchup	அமைச்சுப்
amaiththu	அமைத்து
amaithu	அமைத்து
amaitthu	அமைத்து
amaiththuth	அமைத்துத்
amaithuth	அமைத்து
amaitthuth	அமைத்துத்
amachankalil	அமசசங்களில்
amasankalil	அமசங்களில்
amsangalil	அம்சங்களில்
amsangkalil	அம்சங்களில்
amchankalum	அம்சங்களும்
amsangalum	அம்சங்களு
amsankalum	அம்சங்களும்
amsangalaik	அம்சங்களைக்
amsangazhaik	அம்சாங்களை
amsanggalaik	அம்சங்களைக்
amsaththai	அம்சத்தை
amchamaana	அம்சமான
amchamana	அம்சமான
amsamaana	அம்சமான
ambalavaanar	அம்பலவனார்
ambalavanar	அம்பலவன்
ampalavaanar	அம்பலவன்
ayana	யயனன
ayirai	அயரரி
airoappiya	ஐரோப்பிய
airoopiya	ஐரோப்பியா
airoppiya	ஐரோப்பிய
ayrooppiya	அரோப்பிய
ayropiya	அயூரிபட
europe	ஐரோப்பா
arakka	அரக்க
arrakka	ரகர்க
arakkan	ரரக்கன்
arrakkan	ராக்கன்
arakku	ரகக்கு
araku	ரகூ
aruppukkoattai	அருப்புக்கோட்டை
aruppukkoottai	அருப்புக்கூட்டை
aruppukkottai	அருப்புக்கோட்டை
aruppukoattai	அருப்புக்கோடை
arumbu	பரும்பு
arppaniththa	அர்ப்பந்திட
ariyappatta	அறியப்பட்ட
ariyappattadhu	அறியப்பட்டது
ariyappattathu	அறியப்பட்டது
ariyappattu	அறியப்பட்டு
ariyaar	திராயர்
ariyum	ரியும்
arivadhu	அரிவது
arivathu	அரிவது
arivan	பரிவன்
arivin	அரிவின்
arivar	பரிவார்
arivin	அரிவின்
arivippugalai	அறிவிப்புறை
arivippukalai	அறிவிப்புறலை
arivil	அரிவில்
arivulla	அறிவுள்ள
arupathaam	அருபதாம்
arupathugalil	அருபதுகளில்
arupathukalil	அருபதுகளில்
arupaththu	அருபத்து
aupaththu	அபத்து
araiguuval	அரைகுவு
araikooval	அரைகோவல்
araikuuval	அரைகுவுல்
alagaal	களாள்
alakaal	களாள்
alagil	களின்
alakil	அலிக்
aliyum	மியும்
alavaal	பலவால்
alavukadandhdha	அளவுகட்ந்த
alavukadandhtha	அளவுகட்ந்த
alavukadantha	அளவுகட்டந்த
alavukatandhdha	அளவுகத்தட்டன
alavukatandhtha	அளவுகத்தட்டன
alavugalum	அளவுகளும்
alavukalum	அளவுகளும்
alavugalai	அளவுகளை
alavukalai	அளவுகளை
alavugal	அளவுகள்
alavukal	அளவுகள்
alavukkuch	தளவுக்குச்
alavukkup	அளவுக்கு
alavukkum	தளவுக்கும்
alavulla	தளவுள்ள
alagi	மகளி
alaki	மலகி
azhagi	அழகி
azhaki	அழகி
alaginai	அழகினை
alakinai	அழகினை
alazhaginai	அழகானி
azhaginai	அழகினை
azhakinai	அழகினை
alagin	அழகின்
alakin	அழகின்
azhagin	அழகின்
azhakin	அழகின்
alakiyaana	அழகியான
alazhagiyaana	அழகாயியா
azhagiyaana	அழகியான
azhakiyaana	அழகியான
alagil	களின்
alakil	அலிக்
azhagil	அழகில்
azhakil	அழகில்
azhiththadhu	அழித்தது
azhiththathu	அழித்தது
azhiththana	அழித்தன
azhiththanar	அழித்தனர்
azhiththavan	அழித்தவன்
aliththaan	தளித்தான்
azhiththaan	தழித்தான்
aliththaar	தளித்தார்
azhiththaar	தழித்தார்
aluththi	அழுத்தி
azhuththi	அழுத்தி
alaippu	அழைப்பு
azhaippu	அழைப்பு
avathaaranggalil	அவாதாரங்களில்
avathaarangkalil	அவாதாரங்களில்
avathaaranggal	அவாதாரங்கள்
avathaarangkal	அவாதாரங்கள்
avathaaraththil	அவதாதத்தில்
avatar	அவத்்
avathaar	தவதார்
avanudaiya	அவனுடைய
avaridam	அவரிடம்
avatrtrudan	அவற்றுடன்
avatrudan	அவற்றுடன்
avattrudan	அவற்றுடன்
avalukku	அவளுக்கு
avaludan	அவளுடன்
availaik	பைவிலை
avalaik	அவளைக்
avalaith	அவளைத்து
avalaip	அளைப்
avvagai	வர்வகை
avvakai	சவவகை
aagast	காஸ்ட்
aagust	பகத்
aakast	காட்டான்
agast	காஸ்ட்
august	கோடுட்
auuguust	கோவுட்
avgast	சவகட்டான்
awgast	கவாஸ்ட்
aagivida	ஆகிவிட
aagivita	ஆகிவிட
aakivida	ஆகிவிட
aagividum	ஆகிவிடும்
aagivitum	ஆகிவிடும்
aakividum	ஆகிவிடும்
aaakspoard	ஆக்ஸ்போர்டு
aaksfoard	ஆக்ஸ்போர்டு
aakspoard	ஆக்ஸ்டோர்டு
oxford	ஒக்ஸ்டோர்
aasiramaththirku	ஆசிசரமத்திற்கு
aasiramaththiruku	ஆசிராமத்திற்கு
aasiramaththil	ஆசிரமத்தில்
aachiramam	ஆசிசமரம்
aashram	ஆர்ஷம்
aasiramam	ஆசிரமம்
aasram	ராச்
ashram	மஸ்ராம்
ashramm	அர்ஷம்
asram	சார்
asramm	உதரம்
aasiriyaraakap	ஆசிரியராகப்
assiriyaraagap	ஆசிரியராகப்
aasiriyaraakavum	ஆசிரியராகவும்
assiriyaraagavum	ஆசிரியராகவும்
aanchchanaeyar	ஆஞ்சசேயர்
aanjaneayar	ஆஞ்சலேயர்
aanjchanaeyar	ஆஞ்சனியர்
anjaneyar	அஞ்சரியன்
aadippoora	ஆடிப்போர்
aadippooram	ஆடிப்பரரம்
aadugalil	ஆடுகளில்
aadukalil	ஆடுகளில்
aadubavar	ஆடுபவர்
aadupavar	ஆடுபவர்
aadum	மடுவு
aaduvar	ஆடுவர்
aatti	ஆட்டி
aattin	ஆட்டின்
aangalidam	ஆங்கிலாடம்
aangalitam	ஆங்கிலத்தியம்
aankalitam	ஆங்கிலத்து
aangalin	ஆங்களின்
aankalin	ஆங்களின்
aangalilum	ஆங்களிலும்
aankalilum	ஆங்களிலும்
aangalukkaana	ஆங்களுக்கான
aangalum	ஆங்களும்
aankalum	ஆங்களும்
aangalae	ஆங்களே
aankalae	ஆங்களே
aangalaik	ஆங்களைக்
aankalaik	ஆங்களைக்
aangak	ஆங்கா்
aangal	பங்கள்
aankal	பங்கள்
aanda	ஆண்ட
aanta	ஆர்டான
aandathu	ஆண்டது
aantathu	ஆண்டது
aandanar	ஆண்டனர்
aantanar	ஆண்டனர்
aandarchan	ஆண்டங்கான்
aandarsan	ஆண்டங்கன்
andarshon	அந்தர்னான்
andarson	அண்டாரன்
anderson	மந்தோஸ்னா
aandavar	ஆண்டவர்
aantavar	ஆண்டவர்
aandilirunththu	ஆண்டிலிருந்து
aandilirunthu	ஆண்டிலிருந்து
aandae	ஆண்டே
aantae	ஆண்டே
aatharavaaga	ஆதரவாக
aatharavaaka	ஆதரவாக
aatharavaagach	ஆதரவாச்
aatharavaakach	ஆதரவாச்
aatharvaagach	ஆத்வாசக்
aatharikkavillai	ஆதரிக்கவில்லை
aathmaa	ஆத்ரா
aathmaavin	ஆத்மானிவ்
aathmaavil	ஆத்மாவில்
aanthai	ஆந்தை
aanththai	ஆந்தை
aanaimalai	ஆணைமலை
aan	ரான்
aana	ஆன
ain	யின்
ainn	னியன்
an	ன்
ann	ரன்
ein	ய்ன்
einn	இன்
en	ன்
enn	ன்ன்
on	ரன்
aanmaa	ஆர்நாத
anema	மேனா
aniima	அனிமா
anima	அனிம
animaa	அனிமா
anma	மன்ற
enima	எனி
aanmaavukku	ஆன்வாகுவு
aapirikkaa	ஆபிரிக்க
africa	ஆபிரிக்க
aappirikkaavilum	ஆப்பிரிக்காவிலும்
aappirikkavilum	ஆப்பிரிக்கவில்
africaavilum	ஆப்பிர்காவியும்
aappirikkaavukku	ஆப்பிரிக்குவ்கு
africaavukku	ஆபிரிக்காவ்கு
africavukku	ஆபிரிக்காவுக்கு
aappirikkaavai	ஆப்பிரிக்கவை
africaavai	ஆப்ரிக்காவை
africavai	ஆப்ரிக்கவை
aayeena	ஏயனன
aayina	யயனன
aayeenar	யேயன்
aayinar	யினர்
aayera	ஏயர்
aayira	ஏயற்
aayerakkanakkil	ஆயிரக்கணக்கில்
aayirakkanakkil	ஆயிரக்கணிகள்
aayeraththirkum	ஆயிரத்திற்கும்
aayiraththirkum	ஆயிரத்திற்கும்
aayeraththu	ஆயரர்து
aayiraththu	ஆயிரத்து
aayeraththai	ஆயரத்தை
aayiraththai	ஆயிரத்தை
aayeram	யயர்்
aayiram	யயர்கம்
ayil	ரியில்
oial	ராய்
oil	ரயல்
oill	ரோல்
ouil	ரல்
ouuil	ரோல்
oyal	ராய்
aayulai	யயுளை
aaitha	ஏத்த
aaytha	ஏத்தி
aaivukalin	ஆய்வுகளின்
aayuvugalin	ஆயுகளவின்
aayvugalin	ஆய்வுகளின்
aayvukalin	ஆய்வுகளின்
aaivukalukku	ஆய்வுகளுக்கு
aayvugalukku	ஆய்வுகளுக்கு
aayvukalukku	ஆய்வுகளுக்கு
aaivukalaiyum	ஆய்வுகளையும்
aayvugalaiyum	ஆய்வுகளையும்
aayvukalaiyum	ஆய்வுகளையும்
aaivukal	ஆய்வுகள்
aayvugal	ஆய்வுகள்
aayvukal	ஆய்வுகள்
aaivuk	ராய்க்
aayvuk	ராய்வுக்
aaivukkatturai	ஆய்வுக்குற்றை
aayvukkatturai	ஆய்வுக்குற்றை
aaivukkatturaikal	ஆய்வுக்குறைதைகள்
aayvukkatturaigal	ஆய்வுக்குறவிகள்
aayvukkatturaikal	ஆய்வுக்குறைதிகள்
aaivukkaaaka	ஆய்வுக்காக
aayvukkaaga	ஆய்வுக்காக
aayvukkaaka	ஆய்வுக்காக
aaivukkaana	ஆய்வுக்கான
aayvukkaana	ஆய்வுக்கான
aaivukku	ஆய்வுக்கு
aayvukku	ஆய்வுக்கு
aaivum	ராய்வும்
aayvum	யாவும்
aariyar	ஆரியர்
aariyargalin	ஆரியங்களின்
aariyarkalin	ஆரியங்களின்
aarppaattangalai	ஆர்ப்பட்டங்களை
aarppaattanggalai	ஆர்ப்படங்களை
aarppaattangkalai	ஆர்ப்படங்களை
aarppaattangal	ஆர்ப்படட்டங்கள்
aarppaattanggal	ஆர்ப்படங்கள்
aarppaattangkal	ஆர்ப்படட்டங்கள்
aarppaattam	ஆர்ப்பட்டாம்
aarvaththil	ஆர்வத்தில்
aarvaththai	ஆர்வத்தை
aarvaththaik	ஆர்வதைக்
aarvamum	ஆர்வமும்
aarae	ஏரோ
aarkaadu	ஆர்காடு
aatkaadu	ஆட்காடு
arcod	ஆர்கோடு
aatralaal	ஆட்ராலல்
aatrtralaal	பற்றலால்
aatrtralil	ஆற்றலில்
aattralil	ஆற்றலில்
aatrtralulla	ஆற்றலுள்ள
aattralulla	ஆற்றலுள்ள
aatrtru	ஏற்று
aattru	ஏற்று
aatrtrukku	ஏற்றுக்கு
aattrukku	அற்றுக்கு
aalayangalin	அலயங்களின்
aalayanggalin	அலயங்களின்
aalayangkalil	ஆலையங்களில்
aalayankalin	ஆலையங்களின்
aalayangalai	ஆலையங்களை
aalayanggalai	ஆலையங்களை
aalayangkalai	அலையங்களை
aalayankalai	ஆளையங்களை
aalayath	ஆலையத்
aalayaththirku	அழயத்திற்கு
aalayatthirkku	அலயத்திற்கு
aalayaththukku	அழையத்துக்கு
aalayamum	அலையமும்
aalaiyam	லாயையம்
aalaiyum	லலையும்
aaloachanaikalaiyum	ஆலோசச்சைகளையும்
aaloasanaigalaiyum	ஆலோசனைகளையும்
aaloasanaikalaiyum	ஆலோசனைகளையும்
aaloasanaikalayum	ஆலோசனைகளையும்
aalosanaigalaiyum	ஆலோசனைகளையும்
aalosanaikalayum	ஆலோசனைகளையும்
aaloachanaikal	ஆலோசசைகள்
aaloasanaigal	ஆலோசனைகள்
aaloasanaikal	ஆலோசனைகள்
aalosanaigal	ஆலோசனைகள்
aalosanaikal	லோலசேகன்
ikkaruvi	இக்கருவி
ikkaruviyai	இக்கலுவியை
ekkoottaththil	இக்கோட்டத்தில்
ikkoottaththil	இக்கோட்டத்தில்
engkaethaan	இங்கேதான்
ingaethaan	இங்கேதான்
ingkaethaan	இங்கேதான்
ichaikkaruvi	இயைக்குரி
isaikkaruvi	இசைக்குறவி
ichaikkaruvikalai	இசைக்கவிருகளை
isaikkaruvigalai	இசைக்கவிருவை
isaikkaruvikalai	இசைக்கவிருவை
ichaikkaruviyai	இசைக்கவிமுரை
isaikkaruviyai	இசைக்கவிமுரை
inchchi	இஞ்சி
inchi	இன்சி
injchi	ஜின்சி
idaodhikkeedu	இடோதிக்கோடு
idaodhukkeedu	இடோதுக்கெடு
idaothukkeedu	இடதொகுக்கீடு
idaththila	இடத்தில
idaththilum	இடத்திலும்
idiththu	இடித்து
vittu	வித்து
idippu	இடிப்பு
idugaigalil	இடுக்களைக்
idaiyooraaga	இடையூராக
idaiyooraaka	இடையூராக
idaiyaeyaana	இடையாயன
inaiyaanadhu	இனையானது
inaiyaanathu	இநையானது
inaiyaanavai	இனையானவை
idhanaal	இதனால்
ithanaal	இதனால்
idhanaalthaan	இதனால்தான்
ithanaalthaan	இதனால்தான்
idhara	இரத
itara	ஈதரா
ithara	இரத
othar	தர்
othara	ஒறதர
other	தெதர்
othera	ஒதேர
idhazhaaga	ததழாக
ithalaaka	இதளாக
ithazhaaka	ததழாக
idhoa	தோர்ள்தா
ithoa	தோர்த்து
iththiraippadaththin	இத்திரப்படிததின்
iththiraippadaththai	இத்திரைப்படத்தை
iththeevil	இத்தீவில்
iththeevu	இத்தீவு
indana	இந்தன
indiana	இந்தியானா
inidiiana	இன்னியடானி
inidiyana	இன்யியன்
intiyana	இந்தியன
indiavirkul	இந்தியாவிற்கள்
inthiyaavirkul	இந்தியாவிற்கு
inththiyaavirkul	இந்தியாவிற்கு
indiavil	இந்தியாவில்
inthiyaavil	இந்தியாவில்
inththiyaavil	இந்தியாவில்
indiavai	இந்தியாவை
inthiyaavai	இந்தியாவை
inththiyaavai	இந்தியாவை
indhuk	இந்துக்
indhukkalukku	இந்துக்களுக்கு
innigazhvukku	இந்நிகளுவுகு
inthnikalvukku	இந்நிகளுக்கு
innigazhvai	இந்நிகழ்வை
inthnikalvai	இந்நிகழ்வை
inniruvanangal	இன்நிருண்வலர்
inniruvananggal	இந்நிருகலன்கள்
inthniruvanangkal	இந்நிருந்தவர்கள்
inniruvanam	இன்னிருவனம்
inthniruvanam	இந்நிருவன்
innoayai	இந்நோயை
innooyai	இந்நோயை
inthnoayai	இந்நோயை
inaththavar	இனத்தவர்
enra	என்ற
entra	ஏற்ற
inam	னம்
yenra	என்ற
inavaatham	இனவதாக
inaviruththi	இனவிருத்தி
inaiya	இனைய
incoa	இன்றோ
ingaa	இங்கா
inkaa	இங்கா
innal	இன்னல்
innel	இன்நேல்
innalgal	இந்நல்கள்
innalkal	இந்நல்கள்
innelkal	இன்நெல்கள்
innichai	நிந்சை
innisai	இன்னிசை
innichaik	இன்சினைக்
innisaik	இன்சினைக்
innum	இன்னும்
indralavilum	இன்றலிினும்
inralavilum	இன்றலவிலும்
intralavilum	இன்றலவிலும்
indralavum	இன்றலவும்
inralavum	இன்றலவும்
intralavum	இன்றலவும்
indri	இன்றி
inri	இன்றி
intri	இன்றி
indrith	இன்றித்
inrith	இன்றித்
intrith	இன்றித்
indriyum	இற்றியும்
inriyum	இன்றியும்
intriyum	இற்றியும்
ippadai	இப்படை
ippatai	இப்படை
ipparavai	இப்பவரை
ipparavaigal	இப்பரவைகள்
ipparavaikal	இப்பவரைகள்
ippalli	இப்பல்லி
ippalliyil	இப்பல்லியில்
ippaadhai	பப்பாதை
ippaathai	இப்பாதை
ippaadhaiyil	இப்பாதையில்
ippaathaiyil	இப்பாதையில்
ipporutkal	இப்போருகள்
ippoathaiya	இப்போதைய
ibraahim	இராஹிம்
ibraakim	இராகிமி
ibrahim	இராபிமி
ipraakim	இப்ராகிம்
imayamalaiyin	இமயமையிலின்
himachala	மீசசலா
imaachchala	இமாச்சாள
himachalap	பிமசாசப்
imaachchalap	இமாச்சளி
immakkal	மேமக்கள்
iyakkaththaich	இயக்கத்தைச்
iyakku	இயக்கு
eiyalpaiyum	இய்பாயும்
iyalbaiyum	இயல்பையும்
erattippaaka	இரட்டிப்பாக
irattippaaga	இரட்டிப்பாக
irukka	இருக்க
koodaathu	கூட்டது
koodadhu	கூடது
koodum	கூடும்
kutatu	கூட்ட
irukkap	இருக்கப்
irukkavillai	இருக்கவில்லை
irukkavoa	இருக்கவோ
irukkumpoathu	இருக்கும்போது
iruchakkara	இருச்கரக
irusakkara	இருசகர்க
iruppai	இருப்பை
iruppaiyum	இருப்பையும்
irumal	ருமாள்
irumurai	இருமுறை
irumbuth	ரும்புத்
irumputh	பரும்புத்
irumbub	இரும்புப்
irumpup	இரும்புப்
irugi	ருகி
iruki	ருகி
irugik	இருகி
irukik	மருகிக்
ilakka	இளக்க
ilakkam	இலக்கம்
ilakkin	இலக்கின்
ilakkil	இலக்கில்
ilatcha	இலட்ச
latcha	லட்சா
ilatchaththirkum	இலட்சத்திற்கும்
ilatchiyaththirkum	இலட்சியடுக்கிர்
latchaththirkum	லட்சத்திற்கும்
latchiyaththirgum	லட்சியிடத்துக்கும்
ilatchumi	இலட்சுமி
lakshmi	லக்சிமி
latchchumi	லட்சுமி
illaiyena	இல்லையீன
illaiyenil	இல்லையின்
ilamvayathilaeyae	இளம்யதிலையே
ilamvayathileayea	இளம்யவிலேயே
ilamvayidhilaeyae	இளம்யவில்லேயே
ilanthu	இழந்து
izhanththu	இழந்து
izhanthu	இழந்து
evatrtrukkum	இவற்றுக்கும்
ivatrtrukkum	இவற்றுக்கும்
ivatrukkum	இவற்றுக்கும்
evaa	சவவ
ivaa	இரா்
evai	இரவை
ivai	இரை
evaikalaal	ஏவைகளால்
ivaikalaal	இவைகளால்
evaikalil	இவைகளில்
ivaigalil	இைகளில்
evaikalukku	இவைகளுக்கு
ivaigalukku	இவைகளுக்கு
evaikalae	இவைகளே
ivaigalae	இவைகளே
evaikalai	இவைகளை
ivaigalai	இரைகளை
evaikalaith	இவைகளைத்
ivaigalaith	இரைகளைத்
evaithaan	ரவைத்தான்
ivaithaan	இவைதான்
evaiyellaam	இவையுள்ளாம்
ivaiyellaam	இவையுள்ளாம்
ivvaiyellaam	இவ்வியலாமல்
evaiyae	இவையே
ivaiyae	இவையே
ivvaiyae	இவ்வையே
eesanin	இசனின்
eesan	இயன்
eesal	பர்
eeya	யே
iiya	யயத்து
iya	யா்து
eerppu	எரப்பு
ierppu	யர்ப்பு
irppu	இர்பு
eerppup	பர்ப்புப்
eerppuvisai	பர்புபுவி
eeru	ஏறு
eerugalai	ஏறுகளை
eerukalai	ஏறுகளை
eevu	யருவு
evu	யுவு
ugandha	உகநந்த
ukandha	உகந்த
ungantha	உண்நாத
ugandhavai	ககந்தவை
ukandhavai	குந்தவை
ukanththavai	உகந்தவை
udalilum	உடலிலும்
udalil	ஊடலில்
udalai	உடலை
vittu	வித்து
udalaik	உடலைக்
udalnalam	உடல்லளம்
udaindhadhu	உடைந்தது
udainthathu	உடைந்து
utkolluthal	உட்கொள்ளத்தால்
utkollum	உட்கொள்ளும்
utkolvathu	உட்கோல்வோடு
udpuramaaka	உட்புரமாக
utpuramaaga	உட்புரமாக
utpuramaaha	ஒப்புரமாக
udpuram	உட்புறம்
utpuram	உட்புரம்
unarvaaga	உணர்வாக
unarvaaka	உணர்வாக
vagaigalai	வகைகளை
vagaikalai	வகைகளை
vakaikalai	வகைகளை
unavugalil	உணவுகளில்
unavukalil	உணவுகளில்
unavugalum	உணவுகளும்
unavukalum	உணவுகளும்
unavugalaich	உணவுகளைச்
unavukalaich	உணவுகளைச்
uanvugalaiyum	ஒன்வுகளையும்
unavugalaiyum	உணவுகளையும்
unavukalaiyum	உணவுகளையும்
unavukkaaga	உணவுக்காக
unavukkaana	உணவுக்கான
unavuch	உணவுக்
unavudan	உணவுடன்
unavutan	உணவுடன்
unda	உணர்
unnda	உண்்
unta	உணர்
undaanadhu	உண்டானது
undaanathu	உண்டானது
untaanathu	உண்டானது
unththum	உந்தும்
unthum	முத்து
uppsala	ப்படல்
uppsalaa	ப்பழ
upsala	யச்சல
upsalaa	யூ்சலா
upsalla	உச்லா
uuppsala	ப்பசந்தா
uuppsalaa	ப்பநாசா
uupsalla	ஊர்சலா
uppu	இப்பு
uppugalum	உப்புகளும்
uppukalum	புப்புகளும்
uppum	ப்புத்
umathu	மூது
umai	மைய்
ummaa	உம்வா
uyirinamaaga	உயிரினமாக
uyirinamaaka	உயிரினமாக
uyirinam	உயிரினம்
uyirmai	உயிர்மை
uyirvaala	உயிர்வாழ
uyirvaazha	உயிர்வாழ
uyirvaalum	உயிர்வாலும்
uyirvaazhum	உயிர்வாழும்
uyilil	யூிிலி
uyil	யூயில்
uriththaana	உரித்தான
urga	ஊர்க
uruga	உருக
uruka	ஊருக
urukkiya	ஊருக்கிய
uruvappadaththai	உருவப்படத்தை
uruvappataththai	உருவப்படத்தை
uruvappadam	உருபடபடம்
uruvappatam	உருபட்டவம்
uruvaagak	உருவாகக்
uruvaakak	உருவாகக்
uruvaagavillai	உருவாக்களை
uruvaakavillai	உருவாக்கவில்லை
uruvaagavum	உருவாகவும்
uruvaakavum	உருவாகவும்
uruvaagiyulla	உருவாகியில
uruvaakkaththin	உருவாக்கத்தின்
uruvaakaththirku	உருவாகத்திற்கு
uruvaakkaththirku	உருவாக்கத்திற்கு
uruvaakaththilum	உருவாகத்திலும்
uruvaakkaththilum	உருவாக்கத்திலும்
uruvaakkappadum	உருவாக்கப்படும்
uruvaakkamum	உருவாக்கும்
uruvaakkal	உருவாக்கள்
uruvaakkaamal	உருவாக்கலாம்
uruvaakkuvatharku	உருவாக்குவதற்கு
uruvaakkuvathu	உருவாக்குவது
uraiyaadalgalil	உரையாடல்களில்
uraiyaadalkalil	உரையாடல்களில்
uraiyaatalgalil	உரையாடல்களில்
uraiyaadalgalai	உரையாடல்களை
uraiyaadalkalai	உரையாடல்களை
uraiyaatalgalai	உரையாடல்களை
urangaamal	உரர்மான்
urangkaamal	உறங்காலல்
kondirundha	பொண்டிருந்த
kontirunta	பொட்டிருந்த
kontiruntha	பொண்டிருந்த
uravaaga	உரவாக
uravaaka	உரவாக
urudhiyaana	உறுதியான
uruthiyaana	உறுதியான
urudhiyaanathum	உறுதியானதும்
uruthiyaanathum	உறுதியானதும்
uruppu	இருப்பு
uruppugalin	உறுப்புகளின்
uruppugalukku	உறுப்புகளுக்கு
uruppugalukkum	உறுப்புகளுக்கும்
uruppugalaiyum	உறுப்புகளையும்
uruppugal	உருப்புகள்
uruppukku	உருப்புக்கு
uruppukkum	உறுப்புக்கு
uruppum	பருப்பும்
ulaginai	உலகினி
ulakinai	உலகினி
ulagaip	உலகைப்
vaanoordhi	வானூர்தி
vaanoorthi	வானூர்தி
vaanuurthi	வானுற்தி
vaanuurti	வானூற்டி
vanurti	வண்ட்டி
varukindrana	வருகின்றன
varukinrana	வருகின்றன
uloom	லூம்
ulum	மூன்
ulladakka	உள்ளடக்க
ullatakka	உள்ளடக்க
ulladakkamum	உள்ளடக்கமும்
ullatakkamum	உள்ளடக்கும்
ulladakkum	உள்ளடக்கும்
ullatakkum	உள்ளடக்கும்
ullirunththu	உள்ளிருந்து
ullirunthu	உள்ளிருந்து
ulvaanggiya	உள்வாங்கிய
ulvaangkiya	உள்வாங்கிய
ulvaankiya	உள்வாங்கிய
ulaippukku	உழைப்புக்கு
ulaipputhaan	உளைப்புதான்
uzhaippukku	உழைப்புக்கு
oodaka	ஊடாக
udaka	கடா
uudaaka	ஊடாக
uudaka	கடா
oodagaththil	ஊடகத்தில்
oodakaththil	ஊடகத்தில்
udagaththil	ஊடகத்தில்
uudakaththil	ஊடகத்தில்
oodagaththai	ஊடகத்தை
oodakaththai	ஊடகத்தை
udagaththai	உடகத்தை
uudakaththai	ஊடகத்தை
oodagap	ஓடக்
oodakap	ஊடக்
uudagap	ஊடக்
uudakap	ஊடக்
oodagam	ஊடகம்
uoodagam	ஊடகம்
uudakam	ஊடகம்
oothaa	ஊரா
uuthaa	ஊர்
ooraga	ஊரக
uooraga	ஊரக
uuraaka	ஊராக
oorae	ஊரோ
uurae	ஊறை
oorvalamaaga	ஊர்வலமாக
oorvalamaaka	ஊர்வமளாக
uurvalamaaka	ஊர்வலமாக
expo	ஜெப்போ
yekspoa	பேக்க
enggo	ஜங்கோ
engkoa	இங்கோ
enkoa	இங்கோ
esuppaaniya	புச்சிப்யான
yesuppaaniya	பய்சுப்பாணியா
enchchi	எஞ்சி
enchi	எஞ்சி
enjgi	ஐஞ்சி
enchin	எஞ்சின்
engine	எங்கினி
edukkappadaamal	எடுக்கப்படாமல்
yedukkappadaamal	எடுக்கப்படாமல்
ettappadum	எட்டப்படும்
etttappadum	எட்டப்படும்
ettaavathu	எட்டாவது
ettiyathu	எட்டியது
yettiyathu	எத்தியது
ennikkai	மெணிக்கை
yennikkai	மெணிக்கை
ennikkaiyaana	என்ணிக்கையான
ennikkaiyilum	எண்ணிக்கையிலும்
ennikkaiyil	என்னிக்கையில்
ethargaaka	எத்்காக
etharkaaga	எத்்காக
etharkaaka	எத்்காக
ethiraali	எதிராளி
ethiraaliyin	எதிராளியின்
edhirkka	எதிர்க்க
ethirkka	எதிர்க்க
yedhirkka	எதிர்க்க
edhirkkavillai	எதிர்களவில்லை
ethirkkavillai	எதிர்கள்வில்லை
yedhirkkavillai	எதிர்களவில்லை
edhikkavum	எதிக்கவும்
ethirkkavum	எதிர்க்கவும்
yedhirkkavum	எதிர்க்கவும்
edhirkaamal	எதிர்காலல்
ethirkkaamal	எதிர்க்காலம்
yedhirkaamal	எதிர்காலல்
yedhirkkaamal	எதிர்க்காலம்
edhirpaarppu	எதிர்பார்ப்பு
ethirpaarppu	எதிர்பார்ப்பு
edhirpaarppugal	எதிர்பார்ப்புகள்
ethirpaarppugal	எதிர்பார்ப்புகள்
ethirpaarppukal	எதிர்பார்ப்புகள்
edhuvaaga	எதுவாக
ethuvaaka	எதுவாக
yedhuvaaga	எதுவாக
einid	இனிட்ட
enid	தின்
eniid	பினைட்
eynid	பின்ட்
iinid	இனிடு
inid	இனிட
iniid	இனிட
iynid	இண்டி
yenid	எனிட்ட
enin	தின்ன்
amili	அமிலி
amily	அமிலி
emeli	மெயிலி
emely	மெயிலி
emile	மேலிலா
emili	மேலி
emilie	மேலிலா
emilii	மேலிலை
emily	மெளி
imili	மிழிலை
imilii	மிழ்லி
imily	ரிலி
yemili	மிழி
eytha	யத்து
yeitha	யத்து
eythi	ஊழித்து
yeithi	மீல்து
eythum	தூம்
yeithum	தீரும்
erinththu	எரிந்து
erinthu	எரிந்து
yerinthu	எரிந்து
erinththu	எரிந்து
erinthu	எரிந்து
yerinththu	எரிந்து
elaktraankal	இழக்கார்கள்
electronkal	எலெக்ட்ரிகள்
yekaltraankal	எக்கல்றால்கள்
elimaiyaaka	எளிமையாக
yelimaiyaaga	எளிமையாக
yelimaiyaaka	எளிமையாக
elimaiyaakak	எளிமையாகக்
yelimaiyaagak	எளிமையாகக்
yelimaiyaakak	எளிமையாகக்
el	ர்
yel	யே
yell	மோல்
ezhuthiyulla	எழுதியுள்ள
yeluthiyulla	எழுதியுள்ள
ezhuthiyullathu	எழுதியுள்ளது
yeluthiyullathu	எழுதியுள்ளது
ezhuthiyullanar	எழுதியுள்ளனர்
yeluthiyullanar	எழுதியுள்ளனர்
evarukkum	இவருக்கும்
yavarukkum	இவருக்கும்
evarumae	இவருமே
yavarumae	சவறுமே
eavar	ரவவர்
evar	ரவர்
ever	ரவர்
ewer	ரவர்
ivir	ரிவ்
yavar	யவர்
yevar	ரவர்
evvitha	இவ்வித
yavvitha	யாவ்த்த
evvithak	இவ்வதிக்
yavvithak	யவ்விதக்
evvithaththilum	இவ்விதத்திலும்
yavvithaththilum	யவ்விதத்திலும்
evvithamaana	இவ்விதமான
yavvithamaana	யவ்விதமான
eavvitham	இவ்விதம்
evvitham	இவ்வதிமா
yavvitham	யவ்விதம்
aegapoaka	கேகபோ
aekapoaka	கேகபோ
eekapoaka	பக்கோச
ekapoaka	கேபோக
aekapoagam	கேகபோம்
aekapoakam	கேகபோம்
eekapoakam	பீகாகம்
ekapoakam	கேபோகம்
aengchal	பஞ்சல்
angel	மங்கேல்
aanai	கனை
aenai	ஏனை
yaenai	ஏனை
april	பர்ரில்
aprill	பர்பில்
eepral	பர்கல்
epril	பெர்ல்
aeriya	ஏரிய
eeriya	ஊரிய
eriya	ரிய
yeeriya	ஏறிய
aerkanavae	ஏற்கவேண
earkanavae	ஏற்கவேண
eerkanavae	ஏற்கவேண
erkanavae	எர்காணவே
aerpadak	ஏற்படக்
yerpadak	எற்படக்
yerpadk	எட்படுக்
aerpadakkoodaathu	ஏற்படக்கூடாது
yerpadakkoodiya	ஏற்படக்கூடிய
aerpadavillai	ஏற்படவில்லை
yerpadavillai	எர்படவில்லை
aerpadavum	ஏற்படவும்
yerpadavum	ஏற்படவும்
aerpadavae	ஏற்படவே
yerpadavae	எற்படவே
yerpadave	ஏற்படவே
aerpadaatha	ஏற்படாத
earpadaatha	ஏற்படாத
yerpadaatha	ஏற்படாத
aerpadaamal	ஏற்படாமல்
earpadaamal	ஏற்படாமல்
erpadaamal	எர்படாமல்
aerpaduthal	ஏற்படுதல்
earpaduthal	ஏற்படுதல்
yerpaduthal	ஏற்படுதல்
aerpadum	ஏற்படும்
yaerpadum	ஏற்படும்
yerpadum	ஏற்படும்
aerpaduvatharku	ஏற்படுவதற்கு
yaerpaduvatharku	ஏற்படுவதற்கு
yerpaduvatharku	எற்படுவதற்கு
aerpaduvathudan	ஏற்படுவதுடன்
yaerpaduvathudan	ஏற்படுவதுடன்
yerpaduvathudan	ஏற்படுவதுடன்
aetrtru	ஏற்று
eattru	ஏற்று
eetrtru	ஏற்று
etrtru	ஏற்று
aetrtrukkondathu	ஏற்றுக்கொண்டது
eattrukkondathu	ஏற்றுக்கொண்டது
aetrtrukkondanar	ஏற்றுக்கொண்டனர்
eattrukkondanar	ஏற்றுக்கொண்டனர்
aetrtrukkondu	ஏற்றுக்கொண்டு
eattrukkondu	ஏற்றுக்கொண்டு
aetrtrup	ஏற்றுப்
aettrup	ஏற்றுப்
eetrtrup	பற்றுப்
etrtrup	பற்றுப்
aelakiri	எலகிரி
ealagiri	இழகிரி
elakiri	இலகிரி
yaelagiri	ஜேலிிரி
yaelakiri	யலகிரி
yelagiri	ஜலகிரி
ainaa	இாான
ayna	யனன்
aynaa	யானா
ina	இன
inaa	இனான
odeesee	டெய்ஸி
odeesey	டேசிய
odeessei	டடிசியா
odeessey	டெயிஸ்லா
odici	டோிி
odiisii	டிசி
odiissey	டெயிஸி
odisee	டெரிஸி
odisi	டியிசி
odisii	டிசிசி
odissei	டில்சி
odissi	டடிசி
odssi	டங்கி
odysey	டெய்சி
odysi	டெய்சி
odyssey	டெய்சி
odyssi	டெய்சி
ottaga	ஓட்டாக
ottaka	ஓட்டக
ottagangal	ஓட்டங்கள்
ottaganggal	ஓட்டங்கள்
ottakangkal	ஓட்டங்கள்
chivingi	சிவிங்கி
chivingki	சிவிங்கி
civinki	சிவிங்கி
sivingki	சிவிங்கி
ottagam	ஓட்டகம்
oththadhae	ஒத்தடே
oththathae	ஒத்ததே
oththulaikka	ஒத்துலைக்க
oththuzhaikka	ஒத்துழைக்க
oththulaiyaamai	ஒத்துலையைமை
oththuzhaiyaamai	ஒத்துழைமையை
ondrae	ஒன்றே
onrae	ஒன்றே
oppandha	ஒப்பந்த
oppantha	ஓப்பந்த
oppandhak	ஒப்பந்தக்
oppanthak	ஒப்பந்தக்
oppandhathirgu	ஒப்பதன்றத்தி
oppandhaththirku	ஓப்பதன்றத்தி
oppanthaththirku	ஓப்பதன்றத்தி
oppandhathil	ஓப்பந்ததில்
oppandhaththil	ஓப்பந்தத்தில்
oppanthaththil	ஓப்பந்ததில்
oppandhap	ஓப்பந்தப்
oppanthap	ஓப்பதன்
oppandham	ஒப்பந்தம்
oppantham	ஒப்பதன்
omar	மர்
omer	மர்
orumai	புரை
orumayi	புரைமை
otrai	ஒற்றை
ottrai	ஒற்றை
oadhi	ஊளத்தி
oathi	ஊதி
oodhi	ஊழி
oothi	ஊதி
cakti	கர்தி
chakthi	சத்தி
sakthi	சக்தி
horangal	ோரரங்கள்
oorangal	ரரங்கள்
orangal	ரரங்கள்
vorangal	ரவரங்கள்
ooraandil	ராண்டில்
oraandil	ரோராண்டில்
oovar	ரவவர்
ovar	ரவவர்
over	ரவவர்
ower	ரவவர்
overgal	ஓர்வார்கள்
overkal	ஓர்வார்கள்
kasappu	கசப்பு
kadandhadhu	கடந்தது
kadandhathu	கடந்தது
kadanthadhu	கடந்தது
kadanthathu	கடந்தது
kadamboor	கம்பூர்
kadambur	கடம்பூர்
kadarkarai	கடர்கரை
katarkarai	கடற்றகை
kadarkaik	கரைக்
kadarkaraik	கடற்கரைக்
kadarkaraikku	கடர்களைக்கு
kadarkaraiyin	கடற்களையின்
kadarkaraiyilirundha	கடற்களையிருந்த
kadarkaraiyilirundhu	கடர்களையிருந்து
kadarkaraiyilirunthu	கடற்களையிலிருந்து
kadarkaraiyil	கடர்களையில்
kadarkarayil	கடர்களையில்
kadarkaraiyai	கடற்களையை
kadalul	களடல்
kadavulae	கடவுளை
kadavule	கடவுள்
kadavulgalin	கடவுள்களின்
kadavulkalin	கடவுள்களின்
kadidhangalum	கடிதங்களும்
kadithangalum	கடிதங்களும்
kadithangkalum	கடிதங்களும்
kadidhangalai	கடிதங்களை
kadithangalai	கடிதங்களை
kadithangkalai	கடிதங்களை
kadidhathil	கடிததில்
kadithaththil	கடிதத்தில்
kadithatthil	கடிதத்தில்
kadidhatai	கடிதடதை
kadidhaththai	கடிதத்தை
kadithaththai	கடித்ததை
kadidhamum	கடிதமும்
kadithamum	கடிததும்
kadumaiyaanadhu	கடுமையானது
kadaichi	கடைச்சி
kadaisi	கடைச்
kataisi	கடசசசி
kadaisiyaaga	கடைசியாக
kadaisiyaaka	கடைசியாக
kadaisiyaga	கடைசியாக
katch	கத்
kootch	கூட்டிக்
kutch	குத்
kuutch	கூத்
qootch	கூட்டிக்
qutch	குட்ச்
kattamaikka	கட்டமைக்க
kattamaikkappadum	கட்டமைப்காடதுக்
kattamaikkappatta	கட்டமைக்கப்பட்ட
kattaayamaagum	கட்டாயமாகும்
kattumaana	கட்டுமான
kattumaanangal	கட்டுமனங்கள்
kattumaananggal	கட்டுமனங்கள்
kattumaanap	கட்டுமானப்
kattumaanam	கட்டுமானம்
gana	கன
kana	கன
kanak	கன்
ganangal	கரங்கள்
kanangal	கணங்கள்
kanangkal	கணங்கள்
kanaththil	கனத்தில்
kanaththai	கணத்தை
kanamum	கனவும்
kanavaanathu	கணவானது
kanavanadhu	கணவனது
kanavanathu	கணவனது
kanetham	கனிதம்
kanidham	கனிதம்
kanitham	கனிதத்
kanu	கன்
kandarindha	கண்டறிந்த
kandarindhdha	கண்டறிந்த
kandarintha	கண்டறிந்த
kandarinththa	கண்டறிந்த
kandarindhadhu	கண்டறிந்தது
kandarindhdhadhu	கண்டறிந்தது
kandarinthathu	கண்டறிந்தது
kandarinththathu	கண்டறிந்தது
kandarindhanar	கண்டறிந்தனர்
kandarindhdhanar	கண்டறிந்தனர்
kandarinthanar	கண்டறிந்தனர்
kandarinththanar	கண்டறிந்தனர்
kandedukkappattadhu	கண்டெடுக்கப்பட்டது
kandedukkappattathu	கண்டெடுக்கப்பட்டது
kannaottaththil	கண்னட்்டத்தில்
kannoottaththil	கண்ண்டட்ததததில்
kannoottatthil	கண்னோட்டத்தில்
kannottaththil	கண்னடட்ததததில்
kadhirveechchin	கதிர்விச்சின்
kathirveecchin	கதிர்விச்ஸின்
kathirveechchin	கதிர்விச்சின்
canara	சனரா
kanara	கணறு
kannaiyar	கண்ணையார்
kanniyar	கண்ணியார்
kabila	கபீலா
vairamuththu	வைரமுத்து
vairamuthu	வைரமுத்து
vairamuttu	வைரமுட்டு
committeeyin	முமித்தியின்
committiyin	முதியியின்
kamittiyin	காயித்தியின்
committeeyil	கமித்தியில்
committiyil	கமித்தியில்
kamittiyel	கமித்தியில்
kamittiyil	காய்த்தியில்
kamba	கம்பா
kampa	மம்பா
kambangal	கம்பங்கள்
kambankal	கம்பங்கள்
kampankal	கம்பங்கள்
cumbaththin	கும்பத்தின்
kambaththin	கம்பத்தின்
kambattin	கம்பட்டின்
kampatthin	கம்பத்தின்
kampattin	கம்பட்டின்
kamban	கம்பன்
kampan	கம்பன்
kambaramayanaththil	கம்பரமானதத்தில்
kambaramayanattil	கம்பரமட்டதத்தில்
kamparamayanattil	கம்பரமாயத்தில்
kambarin	கம்பரின்
kamparin	கம்பரின்
kambalaththu	கம்பலத்து
kambalattu	கம்படல்டு
kambazhaththu	கம்பழத்து
kampalattu	கம்பாட்டு
companigal	கம்பினககள்
companygal	கம்பநிகழ்
companykal	கம்பநிகழ்
kampenikal	கம்பீனிகள்
companyin	கம்பினின்
kambeniyin	கம்பேணியின்
kampeniyin	கம்பெணியின்
kayitrtrunaal	கயிற்றுள்ளன
kayittrinaal	கயிற்றினால்
kayitrin	கயிற்றின்
kayitrtrin	கயிற்றின்
kayittrin	கையிற்றின்
kayitrril	கயிற்றில்
kayittril	கைத்திர்
karan	கரன்
karavetti	கரவேத்தி
karache	கரச்சை
karachi	கரைச்
karachii	கராசி
karachy	கரைச்
karrachi	கற்றசி
qarache	கரச்சை
qarachi	கராசி
qarachii	கராசி
qarachy	கரைச்
qarrachi	கற்றி
kariyamila	கரியமில
karunaakara	கருநாகர்
karunakara	கருநகர
karunaakaran	கருநானர்
karunakaran	கருநகரன்
karuththa	வருத்த
karuththaakkam	கருத்தாக்கம்
karuththuk	கருத்துக்
karuthuk	கருதுக்
karuththukalin	கருத்துகளின்
karuththukkalin	கருத்துக்களின்
karuththukkal	கருத்துக்கள்
karuthukkal	கருதுகள்
karumpalagaiyil	கரும்பலையக்
karumpalahaiyil	கரும்பலையில்
karumpalakaiyil	கரும்பலையில்
karumpulligal	கரும்புள்கள்
karumpullikal	கரும்புள்கள்
karnanin	கர்ணனின்
karnannin	கர்ணன்னின்
karna	கர்ணன்
karnaa	கர்ணா
karnnaa	கர்ணாணா
karmangal	கர்மங்கள்
karmanggal	கர்மங்கள்
karmangkal	கர்மங்கள்
karmam	கர்மம்
karpadhil	கற்பதில்
karpathil	கற்பதில்
karpatthil	கற்பத்தில்
karpikka	கற்பிக்க
karpikkappattu	கற்பிக்கப்பட்டு
vitum	பித்து
kalandhukolkiraargal	கலந்துகொள்ளகிறார்கள்
kalandhukolkiraarkal	கலந்துகொள்ளகளிகள்
kalanthukolkiraargal	கலந்துகிறார்களில்
kalanthukolkiraarkal	கலந்துகிறார்களில்
kalaai	களை
kalaay	களை
kalai	களை
kalingap	களிங்தப்
galileo	களிலியா
kalyaana	களையான
kalyana	கலையான
kalyaanap	கலாயணி
kalyanap	களையானப்
kalyaanam	கலாயணம்
kalyanam	கல்யணம்
kallaala	கல்லாள
kallala	கல்ளா
kallum	கொள்ளம்
kalloori	கல்லூரி
kalluri	கள்ளிரை
kaloori	கோலரி
kalloorigalilum	கல்லோரிகளிலும்
kalloorikalilum	கல்லூரிகளிலும்
kallurigalilum	கல்லிறுகளிலும்
kallurigazhilum	கல்லுறிகளிலும்
kallurikalilum	கல்றுகிளலிகும்
kallurikazhilum	கல்லுறிகளிலும்
kalloorigalum	கல்லூரிகளும்
kalloorikalum	கல்லூரிக்கும்
kallurigalum	கல்லிறுகள்
kallurigazhum	கல்லுறிகளும்
kallurikalum	கல்லிறுகள்
kallurikazhum	கல்லுறிக்கும்
kallooriyaaga	கல்லோரியா
kallooriyaga	கல்லோரிய
kalluriyaga	கல்லிறுகை
kalluriyaka	கல்லிருயா
kallooriyilum	கல்லூரியிலும்
kalluriyilum	கல்லிறுமியில்
muraiyil	முறையில்
kalvikkaaga	கல்விக்காக
kalvikkaga	கல்விக்க
kalvikkaka	கல்விக்கதக
kalvikkaana	கல்விக்கான
kalvikkana	கல்விக்கன்
kalvippani	கல்விப்பணி
kalviyaandu	கள்ளியான்று
kalviyilum	கல்வியிலும்
kalviyum	கள்ளியும்
kalviyae	கள்ளியை
kalviye	பள்ளியை
kalviyoadu	கள்ளியோடு
kalviyodu	கள்ளியோடு
kalalai	களளை
kazhalai	களைளை
kalutai	குலடை
kaluthai	களுதை
kazhudhai	களுதை
kavalai	கவலை
kavali	கவளி
kavalaippadum	கவலைப்படும்
kavalaippatum	கவலைப்படும்
kavalaiyae	கவலையை
kavalaiye	கவலையை
kavalaiyee	கவலையை
kavalaiyai	கவலையை
cofee	கோபி
coffee	காப்
kaahpi	காப்பி
kaattup	காட்டுப்
kaattuyir	காட்டியூர்
kaattuvadhaaga	காட்டுவதாக
kaattuvadhaga	காட்டுவதாக
kaattuvathaaga	காட்டுவதாக
kaangiradhu	காங்கிரது
kaangirathu	காங்கிறது
kaankirathu	காங்கிறது
kaangiraan	காங்கிரான்
kaankiraan	காங்கிரான்
kaangiraar	கான்கிறார்
kaankiraar	காங்கிரார்
kaanbiththadhu	கான்பித்தது
kaanbiththathu	கான்பித்தது
kaanpiththathu	கான்பித்தது
kaanbiththaar	கான்பித்தார்
kaanbithththaar	கான்பித்தார்
kaanpiththaar	கான்பித்தார்
kaathalukku	காதலுக்கு
kathalukku	கதலுக்கு
kaathin	காத்தின்
kathin	தாின்
kaathil	கத்தில்
kathil	கத்தில்
kaathirundha	காதிருந்த
kaathiruntha	காதிருந்த
kaaththiruntha	காத்திருந்த
kaatthiruntha	காத்திருந்த
kaapoolil	காபுலி
kabulil	கூபுலில்
kaapaatrik	காப்பாற்க்
kaappaatrik	காப்பாற்றிக்
kaappaatrtrik	காப்பாற்றிக்
kaappeedu	காப்பீடு
kappeedu	கப்பீடு
kaappuk	காப்புக்
kappuk	கப்புக்
kaaranangalukkaaga	காரணங்களுக்காக
kaaranangalukkaaka	காரணன்களுக்காக
karananggalukkaaka	காரணங்களுக்காக
kaaranaththaith	காரணத்தை
kaaranattait	காரணத்தைட்
kaaranatthait	காரணத்தைத்
karanaththaith	கரணத்தைத்
kaaranamaakac	காரணமாகக்
kaaranamaakach	காரணமாகச்
karanamaakach	காரணமாகச்
kaaranamaagattan	காரணமாட்டன்
kaaranamaakaththaan	காரணமாகத்தான்
kaaranamaakattan	காரணமாட்டன்
karanamaakaththaan	கரரணமானதான்
kaaranamaagap	காரணமாகப்
kaaranamaakap	காரணமாகப்
karanamaakap	காரணமாகப்
kaaranamaagavum	காரணமாகவும்
kaaranamaakavum	காரணமாகவும்
karanamaakavum	காரணமாகவும்
kaaranamaagave	காரணமாகவே
kaaranamaakave	காரணமாகவே
karanamaakave	காரணமாகவவ
kaaranamaagum	காரணமாகும்
kaaranamaakum	காரணமாகும்
karanamaakum	காரணமாகும்
kaari	கரி
cargalin	கற்களின்
cargazhin	கற்களின்
kargalin	கற்களின்
karkalin	கற்களின்
cargal	கர்கள்
kaargal	கர்கள்
kaarkal	கர்கள்
cork	கர்
corka	கூர்
corq	கர்
corqa	கர்
garg	கர்
kaarg	கார்
kaark	கர்
kark	கற்
kork	கொர்
qorq	கொர்
carson	கர்சன்
kaarsan	கர்்னன்
karson	கற்சன்
gardan	கர்டன்
garden	கர்டன்
kaardan	கர்டன்
kaartan	கார்டன்
kardan	கர்டன்
kaarthikeyan	கார்த்தியங்
kaartikeeyan	கார்தீகேய்
karthikeeyan	கார்த்தியேன்
karthikeyan	கார்த்தியேன்
cornar	கர்னூர்
corner	கர்னூர்
kaarnar	கார்னர்
carlo	காற்று
carloo	கார்லா
karloo	கர்லோ
caarloos	கர்லூஸ்
caarlos	கர்லூஸ்
carloos	கர்லூஸ்
carlos	கர்லூஸ்
karloos	கர்லோஸ்
karlos	கர்லூஸ்
qarlos	கர்லூஸ்
kaatrin	காற்றின்
katrin	கற்றின்
kaattrae	காற்றே
kaattre	காற்ற
katre	கற்ற
kaalakattangalil	காலகட்டங்களில்
kalakattangalil	கலகத்தங்களில்
kalakattanggalil	கலகத்தங்களில்
kalakattankalil	கலடக்கட்டளில்
kaalakattaththilum	காலக்்டத்திலும்
kalakattaththilum	கலகத்தட்டிலும்
kaalakattaththil	காலகட்டத்தில்
kalakattaththil	கலடகத்தில்
colonygalai	கலலஞரிக்கை
kaalanigalai	காலநிகளை
kaalanikalai	காலநிகளை
colonygal	கொலோனிகள்
kaalanigal	காலனிகள்
kaalanikal	காலனிகள்
kaalaththai	காலத்தை
kaalattai	காலத்தை
kaalatthai	காலத்தை
kaalaththaich	காலத்தைச்
kaalattaic	காலத்தைக்
kaalatthaic	காலத்தைச்
kaalamae	காலமே
kaalame	காலமே
kaalamee	காலமே
kaalaandil	காலாண்டில்
kaalaantil	காளாண்டில்
kaalin	களின்
kaaliya	காலிய
kaaliyaa	காளியா
kaavalthuraik	காவல்துறைக்
kaavalturaik	காவல்துறைக்
kaavalthuraip	காவல்துறைப்
kavalthuraip	கவல்துறைப்
kavalturaip	கவல்துறைப்
kaavalthuraiyaal	காவல்துறையால்
kaavalturaiyaal	காவல்துவையால்
kidakkiradhu	கிடக்கிறது
kidakkirathu	கிடக்கிறது
kitakkirathu	கிதக்கிறது
kitakkiratu	கிதக்கிறது
kidangku	கிடங்கு
kidangu	கிடங்கு
kidanku	கிடங்கு
kitanku	கிடங்கு
kidandha	கிடந்த
kidanta	கிடட்டா
kidantha	கிடத்த
kitanta	கிடத்தினா
kitantha	கிதாந்த
kidandhanar	கித்தனத்்
kidanthanar	கித்தந்தனர்
kitantanar	கிதா்டன்்னன்
vaendiya	போர்டிய
vaendum	கொடு
vendia	கிட்டியா
vendum	கொடும்
ventiya	பெய்டிய
ventum	கொடும்
kidaikkak	கிடைக்க
kidaikkakk	கிடைக்கக்
kidaikkakkoodiya	கிடைக்கக்கூடிய
kidaikkakkudiya	கிடைக்கக்குடிய
kidaikkakudiya	கிடைக்குடிய
kidaikkavillai	கிடைக்கவில்லை
kadaikkaadhadhaal	கடைக்காதலால்
kidaikkaadhadhaal	கிடைக்கதாலால்
kidaikkaathathaal	கிடைத்தகதலால்
kidaikkadhadhaal	கிடைத்தகதால்
kidaikkaadhu	கிடைக்கது
kidaikkaathu	கிடைக்கத்து
kidaikkaatu	கிடைக்காட்டு
kitaikkaathu	கிடைக்கத்து
kitaikkaatu	கிடைக்காட்டு
kidaikkindra	கிடைக்கின்ற
kidaikkinra	கிடைக்கின்ற
kitaikkinra	கிடைக்கின்ற
ginniyaa	கின்றியான
guinea	கினா
kinniya	கின்னிய
kinniyaa	கின்றியான
cuba	கோபா
cubaa	கோபா
cuuba	கூபா
cuubaa	கூபா
kiuba	கோபா
kiubaa	கோபா
kiuuba	குபோ
kiuubaa	குபா
kyuba	கைபோ
kyubaa	கைபா
kyuuba	கியப்பா
kyuubaa	கியாபா
qiuba	கோபா
qiubaa	கீபா
qyuba	கைபோ
qyubaa	கைபா
cubavil	போவளில்
kiyoobaavil	கியோபாவில்
kiyoopaavil	கியோபோவில்
kearan	கேரன்
keeran	கீரன்
kiiran	கிரன்
kiran	ரிகன்
kirann	கிரன்
kyran	ரியன்
qeeran	கீரன்
qiiran	கிரான்
qiran	கிரன்
qirann	கிராண்
qyran	கிரன்
graand	ிராண்டு
graind	கிரெடு
grand	பிராண்டு
grend	கிரெடு
kirand	கிராண்ட
kirubai	கிருப்பை
kirubhai	கிருப்பை
kirupai	கிருப்பை
kirishthavarkalin	கிறிஸ்தவர்களின்
kiriththavargalin	கிறித்தவர்களின்
kiritthavarkalin	கிறித்தவர்களின்
kiriththavargalum	கிறித்தவர்களும்
kiriththavarkalum	கிறித்தவர்களும்
kiritthavarkalum	கிறித்தவர்களும்
kirirththavargal	கிறித்தவர்கள்
kiriththavargal	கிறித்தவர்கள்
kiriththavarkal	கிறித்தவர்கள்
kilovukku	கிழோவுக்கு
clive	கிளிவு
cliwe	கிளிவு
kilaiv	கிளவ்
kilive	கிளிவ்
kilar	கிளர்
kizhaar	கிழார்
kizhar	கிழர்
geets	கீட்
keat	கீட்டா
keats	கேட்டர்
keet	கீட்டா
keets	கீட்டா
kets	கட்டிக்
kiids	கீட்
kiits	கீட்டா்
kits	கிட்
kyts	கதட்ஸ்
qeat	கிட்டா
qeats	கேட்டர்
qiits	கீட்டா்
qyts	கதட்ஸ்
geethanjali	கீத்ஞளி
keethanjali	கீத்ஞழ்
geet	கீட்
geeta	கீட்டா
geethai	கீத்தி
giit	கீட்டா
giitaa	கிட்டா
git	கிட்ட
gita	கிட்ட
geethaiyil	கைதையில்
geethayil	கீதாயில்
keelirangi	கீழிறங்கி
keelirangki	கீழிறங்கி
keeliranki	கீழிறங்கு
keezhiranggi	கீழிறங்கி
keezhirangi	கீழிறங்கி
keezhiranki	கீழிறங்கு
kudandhai	குடத்தை
kudanthai	குடத்தை
kudippalakkam	குடிப்பலக்கம்
kudippazhakkam	குடிப்பழக்கம்
kudai	குடை
kuday	குத்
kutay	குட்டிய
kudaindhdhu	குடைந்து
kudaindhu	குடைந்து
kudainthu	குடைந்து
kudayndhu	குடைந்து
kutaynthu	குடைந்து
kudaiyin	குடையின்
kudayyin	குடையின்
kutayyin	குடையின்
kudaiyil	குடையில்
kudayyil	குடையில்
kutayyil	குடையில்
good	கோட்
goodd	கோட்டி
goud	கோட்
gouud	கோட்டி
gud	கட்டா
gudd	குட்ட
guud	கட்
kud	குட்டி
gunamaa	குணமா
kunamaa	குணமா
kuyili	குயிலி
kurudhik	குறுதிக்
kuruthik	குறுத்க்
kuruvi	குறுவி
guruviyin	குருவியின்
kuriviyin	குறிவியின்
kuruviyin	குறுவியின்
kurdhu	குர்த்து
kurdu	குரும்
kurthu	குருத்து
kurichchi	குறிச்சி
kurichi	குறிச்சி
guru	ருக
kuru	குறு
kurukkup	குருக்குப்
kurukkum	குறுக்கும்
kuruvai	குறுவை
kuraindhavargal	குறைந்தவர்கள்
kuraindhdhavargal	குறைந்தவர்கள்
kurainthavarkal	குறைந்தவர்கள்
kuraindavai	குறைந்தவை
kuraindhdhavai	குறைந்தவை
kurainthavai	குறைந்தவை
kuraindhaal	குறைந்தால்
kuraindhdhaal	குறைந்தால்
kurainthaal	குறைந்தால்
kuraindhae	குறைந்தே
kuraindhe	குறைந்தே
kuraindhey	குறைந்தே
kurainthae	குறைந்தே
kulanggalin	குழங்களின்
kulangkalin	குழங்களின்
kulanggalum	குழங்களும்
kulangkalum	குழங்களும்
kulanggalai	குளங்களை
kulangkalai	குளங்களை
kulanggalaiyum	குழங்களையும்
kulangkalaiyum	குழங்களையும்
kulanggal	குழங்கள்
kulangkal	குழங்கள்
kulaththirku	குலத்திற்கு
kulatthirku	குலத்திற்கு
kulaththu	குளத்து
kulatthu	குலத்து
kulaththukku	குலத்துக்கு
kulatthukku	குலத்துக்கு
kulaththai	குலத்தை
kulaththi	குளத்தி
kulatthai	குலத்தை
kulamum	குலமும்
veentum	கித்து
vendum	கொடும்
ventum	கொடும்
kuliththa	குளித்த
kuliththalai	குளித்தளை
kuliththal	குளித்தல்
kuliththu	குழித்து
kulithu	குளித்து
kulirchchi	குளிற்சி
kulumai	குழமை
kulandhaai	குழந்தாய்
kulanthaai	குழந்தாய்
kulanthai	குழந்தை
kuzhandhaai	குழந்தாய்
kuzhandhaay	குழந்தாய்
kuzhanthaai	குழந்தைய்
kuzhanthai	குழந்தை
kulukkal	குழுக்கள்
kuzhukkal	குழுக்கள்
kuva	புவ
kuvaa	குவா
kuwaa	குவா
kuantam	குந்தாம்
kuantum	குட்டும்
kuantumm	குண்டும்
kuvandam	குவண்டம்
kvantam	கிண்டவு
kwantam	குவந்தம்
quantam	குந்தாம்
quantum	குந்தும்
quantumm	குண்டும்
quuantam	குந்தாம்
quuantuum	குந்தும்
quuantuumm	கூந்தோம்
qwantam	குவிந்தாம்
kuvindhadhu	குவிந்தது
kuvindhathu	குவிந்தது
kuvintatu	குவிந்தட்டு
kuvinthathu	குவிந்தது
kuvindhu	குவிந்து
kuvinthu	குவிந்து
kuvintu	குவிந்து
ggo	கொ
ggoo	கூ
goo	கூடி
gu	ரூக்
guu	ூர்
kuu	ூகூ
koodaadhu	கூடாது
koodaathu	கூட்டது
koodadhu	கூடது
koodathu	கூடதது
koodich	கோடிக்
koodugalil	கூடுகளில்
koodukalil	கோடுகளில்
kuudukalil	கூடுகளில்
kuutukalil	கூடுகளில்
koodumaana	கோடுமான
kuudumaana	கூடுமான
kuutumaana	கூடுமான
koodum	கூடும்
kuudum	குடும்
kuutum	குட்டும்
koottangalin	கூட்டங்களின்
kuuttangalin	கூட்டங்களின்
kuuttankalin	கூட்டங்களின்
koottangalukku	கூட்டங்களுக்கு
kuttangalukku	குட்டங்களுக்கு
kuuttangalukku	கூட்டங்களுக்கு
kuuttankalukku	கூட்டங்களுக்கு
koottangalai	கூட்டங்களை
kuuttangalai	கூட்டங்களை
kuuttankalai	கூட்டங்களை
koottangalaiyum	கூட்டங்களையும்
kuuttangalaiyum	கூட்டங்களையும்
kuuttankalaiyum	கூட்டங்களையும்
koottangal	கூட்டங்கள்
kuuttangal	கூட்டங்கள்
kuuttankal	கூட்டங்கள்
koottath	கூட்டத்
kuuttat	கூட்டத்
kuuttath	கூட்டத்
koottaththin	கோட்டத்தின்
kuutattin	கூடத்தின்
kuuttattin	கூட்டத்தின்
koottaththai	கூட்டத்தை
koottatthai	கோட்டத்தை
koottaththaith	கூட்டத்தைத்
koottatthaith	கூட்டத்தை
kuuttattait	கூட்டத்தைட்ட்
kuuttattaith	கூட்டத்தை
koottappatta	கூட்டப்பட்ட
kuutapata	கூடப்பட
kuuttappatta	கூட்டப்பட்ட
koottamum	கோட்டமும்
kuutamum	கூட்டமும்
kuuttamum	கூட்டமும்
koottam	கோட்டா்
kuutam	கூத்தா்
kuuttam	கூட்டம்
koottavum	கோட்டவும்
kuutavum	கூடவும்
kuuttavum	கூட்டவும்
koottaaka	கூட்டாக
koottaga	கூட்டக
kuuttaaga	கூட்டாக
kuuttaaka	கூட்டாக
koottudhal	கூட்டுதல்
koottuthal	கூட்டுதல்
kootudhal	கூடுதல்
kooththu	கூத்து
kootthu	கூத்து
kuuthu	கூத்து
kuuttu	கூட்டு
kooraiyil	கூறையில்
koorappatta	கூறப்பட்ட
kuurapatta	கூறப்பட்ட
kuurappatta	கூறப்பட்ட
koorappattirukkum	கூறப்பட்டிருக்கும்
kuurappatirukkum	கூறப்படுகிறுக்
kuurappattirukkum	கூறப்பட்டிருக்கும்
koorappattu	கூறப்பட்டு
kuurapattu	கூறப்பட்டு
kuurappattu	கூறப்பட்டு
kooravum	கூரவும்
kuuravum	கூரவும்
kooraamal	கோராமல்
kuuraamal	கூறாமல்
koorai	கூரை
cool	ரோ
cul	ரு
kool	ரோல்
kul	ரு
kuul	ரூ்
qool	ரோ
qul	ரு
kedukkum	கொடுக்கும்
kedum	குடும்
calvin	பள்ளின்
calwin	கள்வின்
kaelvin	கேள்வின்
kalvin	கள்வின்
kalwin	கள்வின்
kelviin	கேள்வின்
kelvin	கேள்வின்
kelvinn	கேள்வின்
kelwiin	கெள்வின்
kelwin	கெள்வின்
kelwinn	கெள்வின்
qalvin	கள்ளின்
qelviin	கேள்வின்
qelvin	கேள்வின்
qelvinn	கேள்வின்
kaettadhu	கட்டதது
kaettathu	கேட்டது
keattathu	கேட்டது
ketadhu	கட்டது
ketathu	கட்டது
kettadhu	கட்டதது
kettathu	கட்டத்து
kaettadhum	கேட்டதும்
kaettathum	கேட்டதும்
ketadhum	கொடத்தும்
ketathum	கொடத்தும்
kaetanar	கீடரன்
kaettanar	கேட்டனர்
kaettapoadhu	கேட்டப்போது
kaettapodhu	கேட்டபோது
kaettapothu	கேட்டப்போது
keattapoothu	காய்தப்போடு
ketapodhu	கேடப்போது
ketapothu	கேடப்போது
kaettaa	கேட்டா
ketta	கட்டா
kaettaar	கேட்டார்
kettar	கேட்டார்
kaettaal	கேட்டால்
keettaal	கீட்டாள்
ketal	கட்டால்
kettal	கட்டால்
kaettullaar	கேட்டுள்ளார்
kettullar	கொட்டுள்ளார்
kaendhiriya	கேந்திரிய
keanthiriya	கீந்திரிய
kendhiriya	கீந்திரிய
kendriya	கென்றிய
keenl	கிண்ல்
keenneel	கீன்றில்
kenel	கென்ல்
kennel	கண்ணேல்
qennel	கண்ணேல்
cameeo	கமேரோ
cameo	கமவோ
cameoo	கமவோ
ccameeo	கமமா
ccameo	கமேரோ
ccameoo	கிமோரியா
kaimioo	கையோர
kaimiu	கையுமை
kameeo	கமேரு
kameo	கமவோ
kameoo	கமவோ
kamio	கமமா
kamioo	கமமோர்
keemiyoo	கியோமியா
kemioo	கீமோர்யா
qaimioo	கையோர
qameo	கம்வு
qamio	கமமா
galeen	களின்
galen	களினன்
gallon	கோலன்
galon	கோன்
keelan	கீழன்
kaelu	களலு
kelu	கொலுள்ள
kael	கள்
kel	கொ்
kezh	கீழ
kaidhigalin	கைதிகளின்
kaidhikalin	கைதிகளின்
kaithigalin	கைதிகளின்
kaithikalin	கைதிகளின்
kaydhikalin	கைதிகளின்
kaythikalin	கைதிகளின்
kadhigalukku	கதிகளுக்கு
kaidhigalukku	கைதிகளுக்கு
kaidhikalukku	கைதிகளுக்கு
kaithigalukku	தைதிகளுக்கு
kaithikalukku	தகிழக்கு
kaidhigalai	கைதிகளை
kaidhikalai	கைதிகளை
kaithigalai	கதிசலை
kaidhigal	கைதிகள்
kaidhikal	கைதிகள்
kaithigal	கைதிகள்
kaidhiyaaga	தைகியாக
kaidhiyaaka	கைதியாக
kaithiyaaga	தகியாக
kaidhiyin	கைதியின்
kaithiyin	கைதியின்
kaipesi	கைப்பே
kaypaesi	கைபேஷி
kaimaari	கைமாறி
kaimari	கைமரி
kaiyaal	கையாள்
kaiyal	கையாள்
kaiyoppamittu	கையோப்படுத்தி
kaivasam	கைவசம்
kodoora	கொடர்
kodura	கொரு
kodooramaaga	கொடரசமாக
kodooramaaka	கொடரசமாக
koduramaga	கொருதாகமா
koturamaka	கொடுர
kodooramaana	கொடரோமான
koduramana	கொருடாமா
konarum	கொன்றும்
kondirukka	கொண்டிருக்க
kontirukka	கொண்டிருக்க
kondirukkak	கொண்டிருக்க
kontirukkak	கொண்டிருக்க
kondirukkavillai	கொண்டிருக்கவில்லை
kontirukkavillai	கொண்டிருக்கவில்லை
kondirukkumpoadhu	கொண்டிருக்கப்போது
kondirukkumpoothu	கொண்டிருக்கோப்போது
kodhikkum	கொதிக்கும்
kothikkum	கொதிக்கும்
kothikum	கொதிக்கும்
gaurila	கோரில
gaurilla	கோரில்லா
gauurilla	கோரில்லா
gorila	கோரில
gorilla	கோரில்லா
gorrila	கோரிலா
gorrilla	கோரில்லா
govrilla	குரில்லா
gowrila	கோளி
gowrilla	குளிர்லா
guarrilla	குரோலிலை
guerilla	குரில்லா
guerrila	குரோலி
guerrilla	குரோலிலை
gureila	குரேலி
gurila	குரில
gurilla	குரில்லா
guuerrilla	குருள்ள
guureila	குரிலா
guurilla	குரில்லா
kaoorilla	கொரில்லா
kolal	கோல்
kollal	கொள்ளள்
kol	கொள்
koll	ரொள்
kolgiraargal	கொள்கிறார்கள்
kolkiraargal	கொள்கிறார்கள்
kolkiraarkal	கொள்கிறார்கள்
kollavum	கொள்ளவும்
kolladha	கொள்ளதா
kollatha	கொள்ளதத
kollaadhavar	கொள்ளவதார்
kolladhavar	கொள்ளதவவா்
kollathavar	கொள்ளதவவா்
kollaadhu	கொள்ளாது
kolladhu	கொள்ளது
kollathu	கொள்ளது
kollvadhaal	கொள்வதால்
kolvadhaal	கொள்வதால்
kolvathaal	கொள்வதால்
kolukattai	கொலுக்கட்டை
kolukkattai	கொலுக்கட்டை
kozhukkattai	கொழுக்கட்டை
kolunthu	கொழுந்து
koluntu	கொளுந்து
kozhundhu	கொழுந்து
kolupil	கொழுப்பில்
koluppil	கொழுப்பில்
kozhuppil	கொழுப்பில்
colombin	கொலும்பின்
columbin	கொலும்பின்
columbu	கொழும்பு
kozhumbin	கொழும்பின்
colombil	கொலம்பில்
columbil	கொலம்பில்
columbu	கொழும்பு
kozhumbil	கொழும்பில்
gokila	கோகிலா
koagilaa	கோகிலா
koakila	கோகில
koatpaatu	கோட்பாட்டு
kootpaadu	கோட்பாட்டு
kootpaatu	கோட்பாட்டு
koatpaatukalin	கோட்பாட்டுகளின்
kootpaadugalin	கோட்பாட்களின்
kootpaadukalin	கோட்பாட்களின்
koatpaatukalum	கோட்பாடுகளும்
kootpaadukalum	கோட்பாடுகளும்
kootpaatukalum	கோட்பாட்டுகளும்
koatpaatukalai	கோட்பாட்டுகளை
kootpaadugalai	கோட்பாட்களை
kootpaadukalai	கோட்பாட்களை
kootpaatukalai	கோட்பாட்டுகளை
koatpaatum	கோட்பாடும்
kootpaadum	கோட்பாடும்
kootpaatum	கோட்பாட்டும்
gobi	கோபி
gobii	கோபி
goobi	கோபி
goopee	கோபி
goopi	கோபி
goopy	கோபி
gopee	கோபி
gopi	கோபி
gopii	கோபி
gopy	கைப்
koabi	கோபி
koapi	கோபி
kobi	கோபிதி
kofee	கோபி
kofi	கோபி
kofii	கோபி
koofee	கோப்
koofi	கோபி
koophee	கோபி
koophi	கோபிதி
koopi	கோபி
kophee	கோபி
kophi	கொபி
kophii	கொபி
qofee	கோபி
qofi	கோபிதி
qophee	கோபி
qophi	கொபிலி
koappai	கோப்பை
koopai	கோபத்
kooppai	கோப்பை
koppai	கொப்பை
koappaigalai	கோப்பைகளை
koopaikalai	கோபைகளை
kooppaigalai	கோப்பைகளை
kooppaikalai	கோப்பைகளை
koppugalai	கொப்புகளை
koappaigal	கோப்பைகள்
koopaikal	கோபைகள்
kooppaigal	கோப்பைகள்
kooppaikal	கோப்பைகள்
koppaigal	கொப்பைகள்
koappaikkaana	கோப்பாக்கான
koopaikkaana	கோபைக்கான
kooppaikkaana	கோப்பாக்கான
koppaikkaana	கொப்பாக்கை
koappaiyin	கோப்பையின்
kopaiyin	கோபையின்
koppaiyin	கொப்பையின்
koappaiyil	கோப்பையில்
kooppaiyil	கோப்பையில்
kopaiyil	கோபையில்
koppaiyil	கொப்பையில்
koappaiyai	கோப்பையை
koopaiyai	கோபையை
kooppaiyai	கோப்பையை
koppaiyai	கொப்பையை
colie	கூலி
colii	கூலி
colli	கொள்ளை
collie	கூலிலை
collii	கொள்ளை
colly	கொள்ளை
coly	களை
coollie	கூலி
coollii	கூலி
coolly	கோளி
goalie	கோலி
goli	கோலி
golli	கோளி
golly	கோலி
goly	களிி
gooalie	கோலிய
goolly	கோலி
koali	கோலி
koli	கோலி
kolli	கொள்ளை
kolly	கொள்லி
koly	கொலிய
kooli	கூலி
koolli	கோளி
koolly	கோளி
qolli	கொள்ளை
qolly	கொள்லி
goliath	கோலியத்
golieth	கோலியத்
gooliath	கோலியத்
kooliyat	கோலியத்
goalgalai	கோள்களை
goalkalai	கோள்களை
kolgalai	கொள்களை
koolgalai	கூள்களை
koolkalai	கூள்களை
goldain	கொள்வைடினான்
goldan	கொள்தன்
golden	கோட்டின்
gooldain	கோலைடின்
gooldan	கோல்டன்
goolden	கோட்டின்
kooldan	கூல்டன்
kooltan	கூள்தன்
colt	கொள்ட்
coolt	கோட்ட
cooltt	கூட்ட
cooult	கூட்ட
coult	கோட்டு
couult	கர்
gauld	கள்
gauuld	களவுட்ட
gold	கொள்ட
golda	கொல்த
goold	கோல்ட்
goolda	கோல்ட
goould	கோல்தட
gould	கள்
gouuld	களவ்ட
kolt	கொல்த்
koold	கோல்த்து
koolt	கோல்ட்
qolt	கொல்த்
golf	கொள்ள்
koolp	கோள்
kolin	கொளின்
koolin	கோளின்
koovalanum	கோவளவும்
kovalanum	கோவளவும்
koovalan	கோவளன்
kovalan	கோவளன்
cauimbatoore	குய்மாற்றோ
cauimbatore	கும்பஸ்தூரி
cauimbetore	கும்பட்டூரி
cauuimbatore	கும்பஸ்தூர்
coimbaatore	கொய்ம்போத்தாரி
coimbaetore	கொய்முப்போறி
coimbatore	கொய்ம்போத்திரி
coimbetore	காய்ம்பூத்திரி
cooimbaatoore	குய்ம்போத்து
cooimbatoore	குய்்மத்துரி
covai	கோவை
koimbatore	கொய்மப்போர்
koimbetore	கொய்மப்பூரில்
kooimbatoore	கொய்ம்போத்திரி
koovai	கோவை
kovai	கோவை
qoimbatore	கொய்மப்போர்
covaiyin	குவையின்
koovaiyin	குவையின்
kovaiyin	குவையின்
covaiyil	கோவியில்
koovaiyil	குவையில்
kovaiyil	குவையில்
gaurava	கரளவ
gowrava	கோரவா
kaurava	கரளவ
gouravikkum	கௌரவிக்கும்
gowravikkum	கோரவிக்கும்
gowrawikkum	கௌரவிக்கும்
kouravikkum	கோரவிக்கும்
cakkarangalai	சக்கரங்களை
cakkarankalai	சக்கரங்களை
chakkarangalai	சக்கரங்களை
chakkarankalai	சக்கரர்களை
sakkarangalai	சக்கரங்களை
sakkaranggalai	சக்கரங்களை
cakkarattin	சக்கராட்டின்
chakkarattin	சக்கரரத்தின்
sakkaraththin	சக்கரத்தின்
cakkarattai	சக்கரட்டை
cakkaratthai	சக்கரத்தை
chakkarattai	சக்கர்ட்டை
chakkaratthai	சக்கரத்தை
sakkaraththai	சக்கரத்தை
cakkarattaip	சக்கரவைத்
cakkaratthaip	சக்கரத்தைப்
chakkaraththaip	சக்கரத்தைப்
chakkarattaip	சக்கரவைத்
chakkaratthaip	சக்கரத்தைப்
sakkaraththaip	சக்கரத்தைப்
chakravarthi	சக்கரவர்த்தி
charavarththi	சரவரத்தி
sakravarththi	சக்கரவ்வத்தி
sangak	சங்கக்
sangkak	சங்கக்
cankangalukku	சங்கங்களுக்கு
cankankalukku	சங்கங்களுக்கு
chankangalukku	சங்கங்களுக்கு
chankankalukku	சங்கங்களுக்கு
sangangalukku	சங்கங்களுக்கு
sangkangkalukku	சங்கங்களுக்கு
cankangalai	சங்கங்களை
cankankalai	சங்கங்களை
chankangalai	சங்கங்களை
chankankalai	சங்கங்களை
sangankalai	சங்கங்களை
sanggangkalai	சங்கங்களை
cankangal	சங்கங்கள்
cankankal	சங்கங்கள்
chankangal	சங்கங்கள்
chankankal	சங்கங்கள்
sangankal	சங்கங்கள்
sanggangkal	மங்கங்கள்
cankat	கர்ண்ட்
cankath	சங்கத்
chankat	சங்கட்
chankath	சங்கத்
sangath	சங்கத்
sanggath	சங்கத்
cankattirku	சங்கத்திற்கு
chankatthirku	சங்கத்திற்கு
sangaththirku	சங்கத்திற்கு
sanggaththirku	சங்கத்திற்கு
sangaththil	சங்கத்தில்
sanggaththil	சங்கத்தில்
sangaththai	சங்கத்தை
sanggaththai	சங்கத்தை
sangamathil	சங்கமதத்
sangamaththil	சங்கமத்தில்
sanggamaththil	சங்கமத்தில்
sankamathill	சங்கமாதில்
sangamam	சங்கமம்
sanggamam	சங்கமம்
sankamam	சங்கமம்
sankamum	சங்கமும்
sangamaaga	சங்கமாக
sangamaaha	சங்கமா
sangamaga	சங்கமாக
sangamaha	சங்கமா
sanggamaaga	சங்கமாக
sangamekkum	சங்கமுக்கும்
sangamigum	சங்கமிகும்
sangamikkum	சங்கமிக்கும்
sanggamikkum	சங்கமிக்கும்
sankamikkum	சங்கமிக்கும்
sangamoom	சங்கமோம்
sangamum	சங்கமும்
sanggamum	சங்கமும்
sankamum	சங்கமும்
sangavai	சங்கபை
sangavi	சங்கபி
sangili	சங்கிலி
sangily	சங்கிலி
sangkili	கங்கிலி
sanggiligal	சங்கிலிகள்
sangiligal	சங்கிலிகள்
sangilikal	சங்கிலிகள்
sanggiliyaal	சங்கிலியல்
sangiliyaal	சங்கிலியால்
sangiliyal	சங்கிலியல்
sanggiliyai	சங்கிலியை
sangiliyai	சங்கிலியை
sangilyyai	சங்கில்யை
cankai	சங்கை
chankai	சங்கை
sangai	சங்கை
sattama	சட்டாமா
sattamaa	சட்டமா
sattai	சட்டை
sattaiyin	டட்டியின்
sattaiyil	டட்டியில்
sattaiyai	சட்டையை
sadhaveedhaththil	சதவயத்தில்
sathaveethaththil	சதவயேதத்தில்
sadhaveedham	சதவதீமம்
sadhaveetham	சதவதீதம்
sathaveetham	சதவதீதம்
sadhi	சதி
satee	சேட்டா
sathi	சதி
sati	சத்தி
satii	சை
satti	உட்டி
setee	சேடே
seti	செட்டி
setii	செய்தி
setti	சேட்டி
satees	சீட்
sateesh	சதேஷ்
satheesh	சதேஷ்
sathis	சதி
sathish	சதிஸ்
satiis	கிட்டிய
satiish	சிதேஷ்
satis	கிட்டிய
satish	சிதேஷ்
setees	சீட்
setiis	சீட்
setis	சித்
sathya	சத்யா
sathyaavin	சத்யாவின்
sathyavin	சத்தியாவின்
santharppangalil	சந்தப்பங்கள்
santharppangkalil	சந்தப்பங்களில்
santharppankalil	சந்தப்பங்களில்
santharppangalai	சந்தப்ப்பங்களை
santharppangkalai	சந்தப்ப்பங்களை
santharppankalai	சந்தப்ப்பங்களை
santharppangal	சந்தப்பங்கள்
santharppangkal	சந்தப்பங்கள்
santharppankal	சந்தப்பங்கள்
santharppaththil	சந்தரப்படத்தில்
santharppam	சந்தப்பாம்
sandhia	சந்திய
sandhiaa	சந்தியா
sandhiya	சந்திய
sandhya	சந்திய
sandhyaa	சந்தியா
santhaippaduththal	சந்தைப்படுத்தல்
sabari	சபரி
sabaiyinaal	சபையினால்
chamakaala	சமாாள
samakaala	சமாாள
samanaana	சமனான
samanana	சமனன
samapangku	சமாபங்கு
samamaaga	சமமாக
samamaga	சமமாக
samamaka	சமமாக
samamaagavum	சமமாகவும்
samamagavum	சமமாவவும்
samamakavum	சமமாவும்
samayath	சமயத்
samarppiththaar	சமற்ப்பித்தார்
samarppiththu	சமற்ப்பித்து
samarppiththullaar	சமற்ப்பித்துள்ளார்
samaiththa	சமைத்த
samayththa	சதய்்த
saimaiththal	சைமைத்தல்
samaiththal	சமைத்தால்
samayththal	சமைத்தால்
samaiththaal	சமைத்தால்
samayththaal	சமைத்தால்
sam	மான்
sum	சும்
samsaaram	சம்சாரம்
samsaram	சம்ரரச்
sambiradhaaya	சம்பிரதாதா
sambradhaaya	சம்பரதாதிய
sambrathaaya	சம்பரத்தா
sampirathaaya	சம்பிரததா
sampirathaya	சம்பிரததா
samprathaaya	சம்பரததா
sambiradhayamaana	சம்பிரதமான
sambirathaayamaana	சம்பிரததமான
sambradhayamaana	சம்பரத்தியான
sambrathaayamaana	சம்பதரியமான
sampirathaayamaana	சம்பிரததாமான
sammandhdhar	சம்நந்தார்
sammanthar	சம்மந்தர்
sarakkugal	கரக்குசல்
sarakkukal	கரக்குசல்
saranadaintha	சரணநடைந்த
saranadainthathu	சரணதடைந்தது
saranadainthaar	சரணத்யந்தார்
saranadainthar	சரணதையின்தார்
saranadainthu	சரணத்யைந்து
curender	குரென்
currendar	குரெட்டர்
currender	குரெட்டர்
cuurrender	குர்டேர்
saranadaiya	சரணத்யை
sarendar	சேரண்டார்
sarrendar	சர்டேர்
surendar	சுரென்ற்
surendarr	சுரென்ற்ற்
surender	சுரென்ட்
surenderr	சுரென்ற்ற்
surrendar	சுற்றநேர்
surrender	சுறிற்ற்
suurenderr	சுரென்ற்ர்
suurrendar	சுறந்தேர்
suurrender	சுரென்றேர்
sarayu	சரைய்
saralamaaga	சாரமாளக
saralamaaka	சாரமாக
saralamaka	சாரமாக
sarala	சரள்
saravanabavan	சரவணவனனன்
saravanabhavan	சரவணவபானன்
saravanapavan	சரவணவனபன்
saritham	சரித்தா்
saritha	சரித்தா
roaga	ரோக
roaka	ரோக
roka	ோராக
rooka	ரோக
sarva	சர்வ
sarvam	சர்வம்
sarvarukku	சர்வருக்கு
servarukku	சேர்வருக்கு
serverukku	சேர்வேறுக்கு
sarvar	சர்வரர்
sarvur	சர்வு
sarwar	சர்வரர்
servar	சீர்வர்
server	சேர்வர்
servur	சர்வுர்
servuur	சர்வூர்
serwar	சேர்வர்
serwer	செர்வர்
serwur	சேர்வர்
survar	சுவற்
surver	சுவர்
surwer	சுர்வேர்
suurver	சுவேர்
sarvargal	சர்வரர்கள்
sarvarkal	சர்வரர்கள்
servergal	சேர்வேற்கள்
serverkal	சர்வீர்கள்
satruth	சுற்றுத்
sattruth	சுற்றது
satrup	சுற்றுப்
sattrup	சுற்றுப்
satrum	சுற்றும்
sattrum	சுற்றும்
satre	சதீர்
sattrae	சட்டேரே
sattre	சட்டர்
saasana	சாசா
sasana	சனசன
saasanangal	சாசஞர்கள்
saasanankal	சாசனங்கள்
sasanangal	சசனங்கள்
sasanankal	சசனங்கள்
saasanaththin	சாசனத்தின்
sasanaththin	சனசத்தின்
saasanaththil	சாசனத்தில்
sasanaththil	சமனத்தில்
saanjchi	சஞ்சி
saanji	சஞ்சி
sanchi	சஞ்சி
sanji	சஞ்சை
saandoa	கா்டியா
sando	சந்தோ
santo	சந்தோ
saadhagam	சாதகம்
saathakam	சாதகம்
sathakam	சதகம்
saadhaaranamaana	சாதானமான
saathaaranamaana	சாதாரமான
saaththiyamaa	சாத்தியாக
chaantha	வாஷணண்ட
kumaari	குமாரி
kumari	குமாரி
saantha	சாந்தி
saanthan	சாந்தினன்
santhan	பந்தன்
saanthappaduththum	சாந்தப்படுத்தும்
saanthappaduthum	சாந்தபுபடும்
saantham	சாந்தாம்
santham	சந்தம்
sanththam	சந்தம்
saamaaniya	சாநாயியா
caaminaathan	சாமினாதன்
chaaminaathan	சாமிநாதன்
saaminaadhan	சாமிநாதன்
saaminaathan	சாமிநாதன்
saaradhigal	சாரதிகள்
saarathigal	சாதரிகள்
saarathikal	சாதரிகள்
saradhigal	சாரதிகள்
sarathigal	சாதரிகள்
sarathikal	சாதரிகள்
chaallukiyar	சால்லுகிய
chalukkiyar	சூல்க்கியர்
chalukyar	சுழக்்
saallukiyar	சால்றுகிய்
saalukkiyar	சாலுக்கிய
sallukiyar	சொல்லுகியார்
chalukiyargal	சலலுகியர்கள்
chalukkiyarkal	சலல்க்கியர்கள்
chalukyargal	சலுயக்கர்
saalukkiyargal	சாலுக்கியக்கள்
saalukkiyarkal	சாலுக்கியர்கள்
salukkiyarkal	சலல்க்கியர்கள்
kei	கையே
key	கேயே
qey	கேயே
saavi	சாவி
saavithri	சிவத்தி
savithri	சவித்திரி
savitri	சவிற்றி
saashthiri	சாஸ்திரி
saasthiri	சஸ்திரி
sasthri	சதரரி
sastree	சாஸ்ரி
sastri	சாஸ்ரி
sastrii	சாஸ்ரி
sastrree	சாஸ்ர்வி
sastrrii	சா்்றி
shastree	சாஸ்டிரி
shastri	சாஸ்ரி
shastrree	சாஸ்ர்வி
saashthirigal	சாத்திரிகள்
saasthirigal	சாத்திரிகள்
sasthirigal	ச்தீரிகள்
shashthrigal	சாத்திரிகள்
chikkana	சிக்கன
sikana	சிக்கன
sikkana	சிக்கன
chikkanamaaka	சிக்கணமாக
sikanamaka	சிக்கமான
sikkanamaaga	சிக்கணமாக
sikkanamaaka	சிக்கணமாக
chikkanamaana	சிக்கணமான
sikanamana	சிக்கமான
sikkanamaana	சிக்கணமான
chittu	சிட்டு
seetu	சீட்டு
seetuu	சீட்டு
siitu	சிடுட்ட
sito	சிடோடோ
sitoo	கிட்டோ
sittu	சிட்டு
situ	சிடுட்ட
situu	சிட்ட
chittuk	சிட்டுக்
sittuk	சிட்டுக்
seeddharth	சீத்தார்த்
seedharth	சீதர்த்
seidharth	செய்ததற்டு
seydharth	செய்ததி
siddharth	சிதறத்தை
sidharth	சிதறத்தி
sidharthh	சிதறத்தி
siiddharth	சித்தரத்தி
siththaarth	சித்தார்ட்
sittharth	சித்தர்ட்
chithirai	சிதிரை
sithirai	சிதிரை
siththirai	சித்திரை
sitthirai	சித்திரை
chithiraip	சித்திரைப்
sithiraip	சிதிதிறைப்
siththiraip	சித்திரைப்
sitthiraip	சித்திரைப்
chinthitthal	சிந்தித்தல்
sinthithal	சிந்திதள்
sinthiththal	சிந்தித்தல்
sinthitthal	சிந்தித்தல்
caardu	முர்ட்
card	கரடடடர்
kaardu	கார்டு
kartu	கர்ட்டு
sim	சிமை
shimman	சிம்பான்
simman	சிம்பான்
simmon	சிம்மோன்
chims	சிம்
semms	செம்ப்
sems	சே
siims	சிம்
simms	சிம்ஸ்
sims	சிம்ஸ்
simss	சின்ஸ்
symms	சிம்பா்
syms	சிம்ஸ்
siraaj	சிராஜ்
siraj	சிராஜ்
sirian	சிரியன்
syrian	சிரியன்
syriyan	சிரியன்
siriap	சிரியப்
siriyap	சிரியப்
syriap	சிரியப்
syriyap	சிறியப்
siridhalavu	சிறிதளவு
siridhazhavu	சிறிதளவு
sirithalavu	சிறிதளவு
siridhu	சிறுது
sirithu	சிறித்து
siridhum	சிறிதும்
sirithum	சிறித்தும்
seelica	கீழியாக
siilica	சிலியாக
silica	சிலிக்க
silicca	சிலியா
silika	சிலிக்க
siliqa	சிலிக்க
silicon	சிலோச்ன்
silikkaan	சிழிக்கான்
silikon	சிலிக்னன்
shiiv	சீவ்
shiv	சிவ்
shiva	சிவா
siiv	சீவ்
siiw	சீவ்
siv	சிய்
siva	சிவா
siw	சிய
siwa	சிவா
sivandhu	சிவந்து
sivanthu	சிவந்து
sivanin	சிவனின்
sivanukku	சிவனுக்கு
sivaperumaanae	சிவபெருமானி
sivaperumane	சிவபெருமானி
sivappiragasa	சிவப்பிரகா
sivappirakaasa	சிவப்பிராக
sivappirakasa	சிவப்பிரகா
sivapragasha	சிதப்பாரகா
sivaprakasa	சிதபராகாச
sivam	சிவா
secret	செர்த்திரி
seekraet	சீகரெட்டு
seedhakkadhi	சிதக்கதி
seedhakkathi	சிதக்கத்தி
seethakathi	சீதகத்தி
seethakkaathi	சீதக்காதி
seethakkadhi	சீதகத்தி
seethakkathi	சீதகத்தி
seenivasa	சீனிவாச
srinivasa	ஸ்ரீனிசா
chiirutai	சீருடை
chirutai	சிறுதை
seerudai	சீருடை
serutai	செருதை
siirutai	சீருடை
cheerutaikal	சீருடைகள்
seerudaigal	சீருடைகள்
seerudaikal	சீருடைகள்
chiirutaip	சீருடைப்
chirutaip	சிருதைப்
seerudaip	சீருடைப்
serutaip	செருதைப்பு
siirutaip	சிருடைப்
seelam	சிலம்
seelaa	சீலா
sheela	சீலா
chukku	சுக்கு
sukku	சுக்கு
chudalai	சுடலை
sudalai	சுடலை
chutalaimaatan	சுடலடமைந்தான்
sudalaimaadan	சுடலடைமான்
sudalaimadan	சுடலடமைடன்
sudalaimatan	சுடலடைமடன்
sutalaimaatan	சுடலடைமடன்
chutthappadutthum	சுத்தப்படுத்தும்
sudhthappaduththum	சுத்தப்படுத்தும்
suthapaduthum	சுதப்படுத்தும்
suththappaduththum	சுத்தப்படுத்தும்
sutthappadutthum	சுத்தப்படுத்தும்
chuthamaana	சுதாமான
suthamaana	சுதாமான
suthamana	சுதாமண
suththamaana	சுத்தமான
sundari	சுந்திரி
sundhari	சுந்தரி
sunthari	சுந்தரி
suba	சுபா
subaa	சூபா
subha	சூப
suraakkal	சுராக்கள்
chutrtrivara	சுற்றிவா
surrivara	சுற்றிவா
sutrivara	சுற்றிவர
sutrtrivara	சுற்றிவர
suttrivara	சுற்றிவா
surrullaa	சுற்றுள்ள
sutrullaa	சுற்றுள்ள
suttrulaa	சுற்றுளா
payanigalai	பயணிகளை
payanikalai	பயணிகளை
payanikalaip	பயணிகளைப்
surrullaap	சுற்றுள்ளப்
sutrullaap	சுற்றுள்ளப்
suttrulaap	சுற்றுளாப்
chuvarin	சுவரின்
suvarin	சுவரின்
chuvarkal	சுவர்கள்
suvargal	சுவர்கள்
suvarkal	சுவர்கள்
suvaasikka	சுவாசிக்க
suvachikka	சுவசிக்க
suvasikka	சுவசிக்க
suvaasikkum	சுவாசிக்கும்
suvachikkum	சுவசிக்கும்
suvasikkkum	சுவசிக்கும்
choottik	சூட்டிக்
chuttik	சுட்டிக்
shoottik	சோட்டிக்
soottik	சூட்டிக்
choottinaar	சூட்டினார்
chuttinar	சுட்டினர்
shoottinaar	சூட்டினார்
soottinaar	சூட்டினார்
soottinar	சூட்டினர்
choothaattam	சூதாட்டம்
soodhaattam	சோதாட்டம்
soothaattam	சூதாத்டம்
sooraavaligal	சூராவளிகள்
sooraavalikal	சூராவளிகள்
sooravazhigal	சூரவழிகள்
sooraavaliyil	சூராவிியில்
sooravaliyil	சூரளவில்ல்
suravaliyil	சுறவலியில்
suravazhiyil	சுறவழியில்
soolappattadhu	சூலப்பட்டது
soolappattathu	சூலப்பட்டது
soozhappattadhu	சூழப்பட்டது
soozhappattathu	சூழப்பட்டது
soolappattullathu	சூழப்பட்டுள்ளது
soozhappattullathu	சூழப்பட்டுள்ளது
suzhappattullathu	சுழப்பட்டுள்ளது
sengkuththaana	செங்குத்தான
sengkutthaana	செங்குத்தான
senguththaana	செங்குத்தான
senkuththaana	செங்குத்தான
chengai	செங்கை
sengai	செங்கை
chenchi	செஞ்சி
gingee	கிங்கி
senchi	செஞ்சி
senjchi	செஞ்சி
senji	சிந்சி
centar	செந்திர
center	செந்திர
centre	கன்னோ
saentar	சேந்தார்
sentar	செந்தார்
centi	சித்தி
senti	செண்டி
caent	கேநாட்ட
cent	சென்ட்டு
scent	ச்னெட்டின்
send	சென்ட்டு
sent	செண்ட்
jeppelin	ஜெப்பிலின்
zepelin	ஜெயலின்
zeppelin	ஜெப்பிளின்
seyarpaadu	செயற்பாடு
seyarpadu	செயற்படட்டு
seyarpaadugalin	செயற்பாடுகளின்
seyarpaadugalilum	செயற்பாடுகளிலும்
seyarpadugalilum	செயற்படுகளிலும்
seyarpaadugalil	செயற்பாடுகளில்
seyarpaadugalukkaana	செயற்பாடுகளுக்கான
seyarpaadugalukku	செயற்பாடுகளுக்கு
seyarpaadugalum	செயற்பாடுகளும்
seyarpadugalum	செயற்படுகளும்
seyarpaadugalai	செயற்பாடுகளை
seyarpaadugalaik	செயற்பாடுகளைக்
seyarpadugalaik	செயற்படுகளைக்
seyarpaadugalaiyum	செயற்பாடுகளையும்
seyarpadugalaiyum	செயற்படுகளையும்
seyalaatra	செயலாற்ற
seyalaattra	செயலாற்ற
seyalatra	செயலற்ற
seyalilandhdhu	செயலலிந்து
seyalilanthu	செயலலிந்து
seyalizhandhdhu	செயலிழந்து
seyalizhandhu	செயலிழந்து
seyalizhandu	செயலிழந்து
seyalukkaaga	செயலாக்காக
seyalukkaga	செயலுக்காக
seyalpadaatha	செயல்படாத
seyalpadadha	செயல்படடட
seyalpadatha	செயல்பட்ட
seyalpatatha	செயல்பட்ட
seyalpadudhal	செயல்படுதல்
seyalpaduthal	செயல்படுதல்
cheyalpadum	செயல்படும்
seyalpadum	செயல்படும்
seyalpatum	செயல்படடும்
cheyalpatumpoothu	செயல்படுப்போது
cheyalpatumpothu	செயல்படுத்து
seyalpadumpoathu	செயல்படுப்போது
seyalpadumpodhu	செயல்படுப்போது
seyalpadumpothu	செயல்படுத்து
seyalpatumpoothu	செயல்படுத்து
cheyalpaduvathu	செயல்படுவது
seyalpaduvadhu	செயல்படுவது
seyalpaduvathu	செயல்படுவது
seyalpatuvathu	செயல்படுவது
cheyalmuraikalai	செய்லுமை
seyalmuraigalai	செய்லுமைகளை
seyalmuraikalai	செய்லுமைகளை
cheyalmuraikal	செய்யுமை
seyalmuraigal	செய்லுறைகள்
seyalmuraikal	செய்லுமைறைக்கால்
cheyalmuraikku	செய்யலுமைக்கு
cheyalmuraiku	செய்லவுரைக்கு
seyalmuraikku	செயல்முறைக்கு
cheyalmuraiyil	செய்யமுறையில்
seyalmuraiyil	செய்லமுறையில்
cheyalmuraiyai	செய்லவியையை
seyalmuraiyai	செய்லவியையை
cheyint	சியின்டு
saent	சேந்த
saint	சைந்த்
saintt	சைந்து
seint	செய்ன்டு
sent	செண்ட்
sentt	சேந்தி
seyint	செயின்ட்
chain	தைன்
chayn	தைன்
chein	தேன்யான்
cheinn	சென்ன்
chen	சன்
cheyin	தியின்
cheyn	திய்ன்
cheynn	சின்
seyin	சினின்
seithathin	செய்ததின்
cheythamaiyaal	செய்தைமாய்
cheythamaiyal	செய்தைமைய்
seidhamaiyaal	செய்தமையால்
seithamaiaal	செய்தமையால்
seithamaiyaal	செய்தமையால்
seythamaiyaal	செய்தைமாய்
cheythavarukku	செய்தவருக்கு
cheythavaruku	செய்தவரவுக்கு
seidhavarukku	செய்தவருக்கு
seithavarukku	செய்தவருக்கு
seythavarukku	செய்தவருக்கு
seidhullaargal	செய்துள்ளார்கள்
seithullaargal	செய்துள்ளார்கள்
seithullaarkal	செய்துள்ளார்கள்
seibavar	செய்பாவர்
shipper	சிப்பர்
siper	சிபெர்
sippar	சிப்பார்
sipper	சிப்பர்
seibavargalae	செய்பவேலாக
seibavargale	செய்பவேள்களை
seibavarkale	செய்பவேள்களை
seibavargal	செய்பவர்கள்
seibavarkal	செய்பவர்கள்
seimadhi	செய்ததி
seimathi	செய்ததி
seiyappatta	செய்யப்பட்ட
seiyyappatta	செய்யப்பட்ட
seiyappattathaaga	செய்யப்பட்டதாக
seiyappattathaaka	செய்யப்பட்டதாக
seiyyappattadhaaga	செய்யப்பட்டதாக
seiyyappattathaaka	செய்யப்பட்டதாக
seiyappattathu	செய்யப்பட்டது
seiyyappattadhu	செய்யப்பட்டது
seiyyappattathu	செய்யப்பட்டது
seiyappattathum	செய்யப்பட்டதும்
seiyyappattadhum	செய்யப்பட்டதும்
seiyyappattathum	செய்யப்பட்டதும்
seiyappattanar	செய்யப்பட்டனர்
seiyyappattanar	செய்யப்பட்டனர்
seiyappattapoothu	செய்யப்பட்டபோது
seiyappattapothu	செய்யப்பட்டபட்டு
seiyyappattapodhu	செய்யப்பட்டபடு
seiyyappattapothu	செய்யப்பட்டபடு
seiyappattavudan	செய்யப்படவட்டான்
seiyyappattavudan	செய்யப்படவட்டனன்
seiyappattavai	செய்யப்படவை
seyyappattavai	செய்யப்படவை
seiyappattaan	செய்யப்பட்டான்
seiyappattan	செய்யப்பட்டன்
seyyappattan	செய்யப்பட்டன்
seiyappattaar	செய்யப்பட்டார்
seiyappattar	செய்யப்பட்டார்
seyyappattar	செய்யப்பட்டார்
seiyappattaalum	செய்யப்பட்டாலும்
seiyappattalum	செய்யப்பட்டாலும்
seyyappattalum	செய்யப்பட்டாலும்
seiyappattirundha	செய்யப்பட்டிருந்த
seiyappattiruntha	செய்யப்பட்டிருந்த
seyyappattiruntha	செய்யப்பட்டிருந்த
cheyyappattu	செய்யப்பட்டு
seiyappattu	செய்யப்பட்டு
seiyyappattu	செய்யப்பட்டு
seyyappattu	செய்யப்பட்டு
seiyappattullaar	செய்யப்பட்டுள்ளார்
seiyappattullar	செய்யப்பட்டுள்ளார்
seyyappattullar	செய்யப்பட்டுள்ளார்
seiyul	கையுள்
seyyul	செய்யு
seiyulgal	கெய்யுள்கள்
seyyulgal	கெய்லுக்கல்
seyyulkal	கெய்ல்கள்
cherbiya	செர்பிய
cherbiyaa	செர்பியா
sarbbiis	சர்ப்பி
sarbia	சர்பியா
sarbiya	சர்பிய
serbbiis	ச்பிப்ய்
serbia	சிர்பி
serbiia	ச்பீரியா
serbiis	ச்ரீப்
serbiya	செர்பிய
serbiyaa	செர்பியா
cherinthu	செரிந்து
serindhu	சேரிந்து
serinthu	சிரிந்து
chelavidum	செலவிடும்
selavidum	செலவிடும்
cheluthinar	வெலுத்தினார்
chelutthinar	செலுத்தினர்
seluthinar	செலுத்தினார்
seluththinar	செலுத்தினர்
selutthinar	செலுத்தினர்
sevvaai	சவவவாய்
sevvaaik	சேவ்வாய்
segariththu	சேகரித்து
sekariththu	சேகரித்து
segarippadhil	சேகரிப்பதில்
sekarippathil	சேகரிப்பதில்
segarippadhu	சேகரிப்பது
sekarippathu	சேகரிப்பது
segarippu	சேகரிப்பு
sekarippu	சேகரிப்பு
segaripputh	சேகரிப்புத்து
sekaripputh	சேகரிப்புத்
chaethamadainththa	சேதமைந்தடை
saethamadainththa	சேதமைந்தடைந்த
sedhamadaindha	சிதமைட்டன
sethamadaindha	சேதமைட்டநாத்
chaethamadainththu	சேதமடைந்து
saethamadainththu	சேதமைட்டந்து
sedhamadaindhu	சிதமைட்டணு
sethamadaindhathu	சேதமைைட்டது
chaethamadainththana	சேதமைந்தனந்த
saethamadainththana	சேதமைந்தனதன
sedhamadaindhana	சிதமைட்டநந்த
sethamadaindhana	சேதமைந்தனந்த
saei	சேயே
saey	சிய்
sei	சையே
sey	சையே
cheralaathan	சேரளதான்
saeralaathan	சேரளாதன்
saeralathan	சேரளதான்
seralathan	சேரளதான்
chairil	சிரில்
saeril	சேரில்
saerkkai	சேர்க்கை
serkkai	சேர்க்கை
saerkkaigal	சேர்க்கைகள்
serkkaikal	சேர்க்கைகள்
saerkkaiyaal	சேர்க்கையால்
serkkaiaal	சேர்க்கையள்
serkkaiyaal	சேர்க்கையால்
saerkkaiyin	சேர்க்கையின்
serkkaiin	சேர்க்கைடின்
serkkaiyin	சேர்க்கையின்
saertkkiyai	சேர்க்கியதை
serkaiai	சீர்கையை
serkkaiyai	சேர்க்கையை
saerththuch	சேர்த்துச்
serththuch	சேர்த்துச்
saerththum	சேர்த்தும்
serththum	சேர்த்தும்
saernthu	சேர்ந்து
serndhu	சேர்ந்து
sernthu	சேர்ந்து
saigai	சைகை
syigyi	சிய்னி
saigaigal	சைகைகள்
saigaikal	சைகைகள்
saikaigal	சைகைகள்
saikaikal	சைகைகள்
cybe	பிய்
cype	சைப்
saip	சைப்
sybe	சிபே
sype	சிபெ
saaiman	சாய்னன்
seiman	செய்மன்
simon	சிமோன்
symon	சிமோன்
sailaja	சைலா
sailajaa	சைலாா
shailaja	சைலா
cittanta	கிட்டண்டா
siththaantha	சித்தாந்த
siththandha	சித்தந்த
saivak	சைவக்
saivath	சைவத்
pirakaasa	பிரகாச
pirakaca	பிரகாச
saivam	சிவம்
saivargal	சிவர்கள்
saivarkal	சிவர்கள்
sothai	சோதை
soththai	சொத்தை
sonthamaa	சொந்தமா
chollukkaana	சொல்லுக்கான
cholukana	சொலுக்கான
sollukkaana	சொல்லுக்கான
chollukku	சொல்லுக்கு
choluku	கொலுள்க
sollukku	சொல்லுக்கு
chollunkal	சொல்லுங்கள்
cholunkal	கொல்லா்கள்
sollungkal	சொல்லுங்கள்
sollunkal	சொல்லுங்கள்
cholludan	சொல்லுடன்
chollutan	சொல்லுடன்
choludan	கொளுடன்
solludan	சொல்லுடன்
solvadhaga	சொல்வதாக
solvathaaga	சொல்வதாக
solvathaaka	சொல்வதாக
solvathaga	சொல்வதாக
cholvathu	சொல்வது
solvadhu	சொல்வது
solvathu	சொல்வது
solvavathu	சொல்வவது
cholvathenraal	சொல்வதற்தேல்
solvadhenral	சொல்வதேற்னல்
solvathenraal	சொல்வதேற்னால்
solvathenral	சொல்வதேற்னர்
solvathentraal	சொல்வத்தென்றால்
cholvathai	சொல்வதை
solvadhai	சொல்வதை
solvathai	சொல்வதை
soasalisa	சோசலியா
socialisa	சொசிலேயா
sosalisa	சோசலியா
choathikkum	சோதிக்கும்
soathikkum	சோதிக்கும்
sothikkum	கோதிக்கும்
choazhapuram	சோழப்பும்
cholapuram	சொல்பாரம்
chozhapuram	சோழப்பும்
soazhapuram	சோழப்புும்
solapuram	சொல்பாரமும்
sozhapuram	சோழப்புறம்
choazhar	சோழர்
cholar	சோற்
chozhar	சோழர்
soazhar	சோழர்
sozhar	சோழர்
choazharkalin	சோழர்களின்
cholarkalin	சோழர்களின்
chozhargalin	சோழர்களின்
soazharkalin	சோழர்களின்
solarkalin	சோழர்களின்
sozharkalin	சோழர்களின்
choazharkalukku	சோழர்களுக்கு
chozhargalukku	சோழர்களுக்கு
soazhargalukku	சோழர்களுக்கு
soazharkalukku	சோழர்களுக்கு
solarkalukku	சோழர்களுக்கு
sozharkalukku	சோழர்களுக்கு
choazharkal	சோழர்கள்
cholargal	கோளர்கள்
chozhargal	சோழர்கள்
soazhargal	சோழர்கள்
soazharkal	சோழர்கள்
solarkal	சோழர்கள்
sozharkal	சோழர்கள்
choudhri	குத்திரி
chowdhri	சோதி
chowdhry	சோத்லி
chowthri	சோத்திரி
southri	சோத்திரி
japanin	ஜபனின்
jappaanin	ஜப்பானின்
japanai	ஜபன்னை
jappaanai	ஜப்பானை
jaapaan	ஜபான்
jaapan	ஜபன்
japaan	ஜபான்
japan	ஜபன்
jappaan	பப்பான்
jappan	ஜப்பான்
zaapaan	ஜபான்
zaapan	ஜபான்
zapaan	ஜபான்
zapan	ஜபன்
jappaar	ஜப்பார்
jaadhav	ஜாத்
jaathav	ஜாத்
jadav	ஜடவ்
jaanukku	ஜானுக்கு
jhonukku	மூனுக்கு
johnukku	ஜோனக்கு
jaaliyan	கலியன்
jaliyan	கலியன்
jallian	ஜல்லியன்
jolyan	ஜோலையான்
jeeva	ஜீவ
nathi	நதி
nati	நித்தி
jeevaathmaa	ஜீவாதா
jeevathma	ஜீவத்தா
jaed	மெட்
jaet	ஜெய்ட்
jait	ஜெய்ட்
jed	டை
jet	ஜிய்ட்
jett	ஜெட்டி
zaet	ஜிட்ட்
zait	ஜையதடு
zed	டை
zet	மெட்
zett	மேட்ட
gen	ஜன்
jaen	ஜன்
jain	ஜின்
jayn	ஜன்
jeen	ஜின்
jen	ஜன்
jenn	ஜன்
zain	ஜின்
zayn	ஜன்
zeen	ஜின்
zen	ஜின்
zenn	ஜன்
jaennr	ஜென்று
jener	ஜினர்
jennar	ஜெனர்
jenner	ஜென்
zenner	ஜென்
jane	ஜன்
jean	ஜின்
jen	ஜன்
joordan	ஜோர்டன்
jordaan	ஜோர்டான்
jordan	ஜோர்டன்
jorddan	ஜோர்டன்
jurdan	ஜ்தான்
zoorann	ூர்னன்
zoordan	ரூர்டன்
zoorddan	ஜோட்டன்
zordan	ஜர்டன்
zorddan	ராத்தன்
joarthaan	ஜோர்தான்
jordan	ஜோர்டன்
jorthaan	ஜோர்தான்
touff	டப்
tough	தூக்
daglas	டளாள்
daklas	டள்காஸ்
daklus	களூன்
douglas	டுகள்
douglass	டுள்க்ஸ்
douuglas	டுகள்
douuglass	டுள்க்ஸ்
duglas	டுகளேஷ்
duglus	ட்கள்
duuglas	டுகளேஷ்
duugluus	ட்கள்
taklas	டள்காஸ்
taklash	களாதேஷ்
taklus	கள்ளு
darpoo	தர்போ
tarbo	தரப்பு
tarboo	தர்போ
turbau	துருப்பி
turbo	துர்போ
turboo	துர்போ
tuurbauu	துருபு
tuurbo	துரூப்
daadaa	தா
taata	தா
taataa	தாடா
taeta	தீடா
taetaa	தீடா
tata	தா
tataa	தா
teta	தட்டா
tetaa	தோடா
dance	டங்கி
dans	டன்
taans	டன்
tains	ட்ன்
tans	ட்ன்
tens	ட்ன்
torch	ரோட்
daarvin	டரரின்
daarwin	டார்வின்
darvin	டர்ளின்
darvinn	டர்ளின்
darvyn	பர்தின்
darwin	டர்வின்
darwinn	டர்வின்
darwyn	டர்னைன்
taarvin	பர்ளின்
doon	டூனின்
dun	டுடன்
duun	டுன்
toon	டூனின்
toonn	டூன்ன்
toun	டுவோன்
touun	டுரன்
tun	து
tunn	டுன்
tuun	துவன்
decsaas	ட்காச்
teksaas	டிகாஸ்
texas	டெகஸஸ்
daeevid	தீவிட்ட
daevid	தேவிட
daewid	டேவிட்
david	டவித்
davidd	டவிட்டா
dawid	டவிய்
dawidd	டவிய்த்
deevid	தீவிட்ட
devid	தீவிட்ட
dewid	டிவீட்
tevid	டுவித்
davidson	டி்
dawidson	டி்
tevitsan	படித்தன்
daai	டையா
daaii	டை
dae	டீ
dai	டையே
daie	டே
daiie	டே
dee	டீ
die	டீ
diie	டீ
dye	டீ
taai	தை
tae	தீஒசை
tai	தை
tie	யீர்
daiddaniyam	டட்டாணியம்
taitanium	டைட்னியயும்
taitaniuum	டைட்னணியும்
tetanium	டீட்டானியு
tietanium	டியட்டியு
tietaniuum	தியத்தியா்
tightaniam	திக்ட்டியன்
tiitanium	திட்டாியும்
tiitaniuum	திட்டனியும்
titaniam	திதாணியம்
titanium	திதானியம்
titaniumm	திட்டணியம்
titaniuum	திட்னணியு
titaniuumm	திட்டணியும்
dailar	டெலார்
tailer	டெல்லர்
tiler	டில்ர்
tylar	தில்
tyler	டில்ர்
daoopakoo	டோபோ
tabago	தபோ
tabagoo	தோோ
tobaggo	தோபோ
tobago	தோபோ
tobagoo	தோபோ
tobagu	தோபோ
toobaggoo	தோபோ
toobagoo	தோபோ
dhonee	தோனே
dhoni	தோனி
dhonii	தோனிய
dhoonee	தூனி
dhooni	தூனி
dhoonii	தூனியை
dhuni	துணி
doani	தோனி
donie	டுனே
donnie	டுனி
dooni	டுனி
doonnie	டுனி
toni	துனி
tonii	துனி
tony	தன
tooni	துணி
toonii	டுனிய
toony	டுனி
thangich	தங்கிச்
thankich	தங்கிச்
thangiya	தங்கிய
thangkiya	தங்கிய
thankiya	தங்கிய
thangiullathu	தங்கிலுள்ளது
thangiyulladhu	தங்கியுள்ளது
thangiyullathu	தங்கியுள்ளது
thankiyullathu	தங்கியுள்ளது
thadangalil	தடங்களில்
thadanggalil	தடங்களில்
thadangkalil	தடங்களில்
thadaya	தடாய
thadayangalai	தடையங்களை
thadayanggalai	தடையங்களை
thadayangkalai	தடையங்களை
thadayangal	தடைந்கள்
thadayanggal	தடைநக்கள்
thadayangkal	தடைந்கள்
thaduththa	தடுத்த
thaduththana	தடுத்தன
thaduththaar	தடுத்தார்
thadutthaar	தடுத்தார்
thadaigalai	தடைகளை
thadaikalai	தடைகளை
thadaykalay	தடைகளை
thadaigalaith	தடைகளைத்
thadaikalaith	தடைகளைத்
thadaykalayth	தடைகளைத்
thadaipattathu	தடைபட்டது
thadaiyum	தடையும்
thadaiyai	தடையை
dakshinaamurthy	காள்சினாத்திரி
dhadchanaamoorthi	தட்காணமூர்தி
dhadchinamoorthi	தட்சின்மூரததி
dhakshinaamoorthy	தாக்கினாநோதி
tatchinamurthy	டட்சினமுந்தி
thakshinaamoorththi	தாக்கினாலிந்து
thattaan	தட்டான்
thandanai	துண்டணை
dhandanaigal	தர்னதைகள்
thandanaigal	தர்னத்
thandanaikal	தர்னத்தைகள்
dhandanaiyilirundhu	தந்தனையிலிருந்து
thandanaiyilirundhu	தந்தணையிலிருந்து
thandanaiyilirunthu	தந்தணையிலிருந்து
thandavaala	தண்டவாளா
dhandavaalangal	தண்டவாளங்கள்
thandavaalanggal	தண்டவநாளர்கள்
thandavaalangkal	தண்டவலாகங்கள்
thandin	தாண்டின்
thandhira	தந்திர
thanthira	தந்திர
thandhirangalil	தந்திரங்களில்
thanthirangazhil	தந்திரங்களில்
thanthiranggalil	தந்திரங்களில்
thanthirankalil	தந்திரங்களில்
thandhirangal	தந்திரங்கள்
thanthiranggal	தந்திரங்கள்
thanthirankal	தந்திரங்கள்
thandhiraththai	தந்திரத்தை
thanthiraththai	தந்திரத்தை
thanakkaaga	தனக்காக
thanakkaga	தனக்க
thanithani	தனித்தனி
thaniththani	தன்திதனை
thanikthanik	தனித்தகின்
thanithanik	தனிதனிக்
thaniththanik	தன்திதனின்
thanithaniyaga	தனித்தினாக
thaniththaniyaaga	தனித்தினையாக
thanithaniyaagap	தனித்தினாகப்
thaniththaniyaagap	தனித்தினைகள்
thanithaniyana	தனித்தனியான
thaniththaniyaana	தன்தியநாதியான
thanithanmaiyana	தனித்தனையான
thaniththamaiyaana	தன்திதமையான
thaniththanmaiyaana	தனித்தன்மையான
thanithanmaiyudan	தனித்தன்னையும்
thaniththanmaiyudan	தனித்தன்மையுடன்
thaiththuvamaana	தைத்துவரான
thaniththuvamaana	தனித்துவனாக
thanithuvamana	தன்திதுவமான
thaniththuvamaanadhu	தனித்துவதாக
thaniththuvamaanath	தனித்துவதனாம்
thaniththuvamaanathu	தனித்துவதாக
thanithuvamanadhu	தன்திவமானது
thanimangalin	தனினங்களின்
thanimankalin	தனினங்களின்
vaayaal	காய்்
vayal	களயல்
thabasu	தபாசு
thapasu	தபாய்
thamakena	தமமேகிர
thamakkaena	தமக்கேன
thamakkena	தமக்கீன
tamilagaththilirunthu	தமிழாகத்திலிருந்து
tamilagatthilirundhu	திமுமாதிலிலிருந்து
tamilakatthilirundhu	தமிழாகத்திலிருந்து
tamizhagatthilirundhu	திமுகாத்திலிருந்து
tamizhakatthilirundhu	திமுகாலத்திலிருந்து
thamilagatthilirundu	தமிழாகத்திலிருந்து
thamilakatthilirundhu	தமிழாகத்திலிருந்து
thamizhagatthilirundhu	திமுகாத்திலிருந்து
thamizhakaththilirundhu	தமிழாகத்திலிருந்து
thamizhakaththilirunthu	தமிழாகத்திலிருந்து
thamizhakatthilirundhu	திமுகாத்திலிருந்து
tamilagaththilum	தமிழாகத்திலும்
tamilagatthilum	தமிழாகத்திலும்
tamilakatthilum	தமிழாகத்திலும்
tamizhagatthilum	திமுகத்திலும்
tamizhakatthilum	திமுகாத்திலும்
thamilagatthilum	தமிழாகத்திலும்
thamilakatthilum	தமிழாகத்திலும்
thamizhagatthilum	திமுகத்திலும்
thamizhakaththilum	தமிழாகத்திலும்
thamizhakatthilum	திமுகத்திலும்
tamilagaththu	தமிழாகத்து
tamilagatthu	தமிழாகப்
tamilakatthu	தமிழாக்கத்து
tamizhagatthu	திமுகத்தா
tamizhakatthu	திமுகப்்டது
thamilagatthu	திமுகத்தா
thamilakatthu	தமிழாக்கத்து
thamizhagatthu	தினாகத்து
thamizhakaththu	திமுகத்தி
thamizhakatthu	திமுகப்்டதத்
tamilagaththukku	தமிழாகத்துக்கு
tamilagatthukku	தமிழாக்கத்து
tamilakatthukku	தமிழாக்கத்து
tamizhagatthukku	திமழாக்கத்து
tamizhakatthukku	திமுகாடத்துக்கு
thamilagatthukku	தமிழாகடுத்து
thamilakatthukku	தமிழாகட்டுக்கு
thamizhagatthukku	திமுகத்துக்கு
thamizhakaththukku	திமுகாத்துக்கு
thamizhakatthukku	திமுகத்துக்கு
tamilagaththai	தமிழாதத்தை
tamilagatthai	தமிழாடத்தை
tamilakatthai	தமிழாகட்டை
tamizhagatthai	திமழாத்தடை
tamizhakatthai	திமழக்்
thamilagatthai	தமிழாட்டதை
thamilakatthai	தமிழாட்டதை
thamizhagatthai	திளமாகத்தை
thamizhakaththay	திமுகத்தை
thamizhakatthai	திமுகாட்தை
tamilagaththaich	தமிழாகத்தைச்
tamilagatthaich	தமிழாதத்தைச்
tamilakatthaich	தமிழாகத்தைச்
tamizhagatthaich	திமழாதக்கு
tamizhakatthaich	திமுகாதத்தைக்
thamilagatthaich	திமழிதகத்தைக்
thamilakatthaich	தமிழாகத்தைச்
thamizhagatthaich	திமுசடகததில்
thamizhakaththaych	திமுகாதத்தில்
thamizhakatthaich	திமுகாத்தைச்
tamilagap	திமழாகப்
tamilakap	தமிழகப்
tamizhagap	திமாகப்
tamizhakap	திமழகப்
thamilagap	தமிழபாப்
thamilakap	தமிழகப்
thamizhagap	தமிழகப்
thamizhakap	தமிழகப்
tamilagam	தமிழாகம்
tamilakam	தமிழக்கம்
tamizhagam	திமாகவ்
tamizhakam	திமமாகக்
thamilagam	தமிழகம்
thamilakam	தமிழக்கம்
thamizhagam	திமாகவ்
thamizhakam	திமமாகக்
tamilarinar	தமிழிருந்தார்
tamilaringar	திமிழிரங்க
thamizharingar	திமழிற்கள்
thamizharingyar	தமிழரியங்க
tamilaiyum	தமிழுயயும்
tamizhaiyum	தமிழையும்
thamilaiyum	தமிழுயயம்
thamillaiyum	தமிழ்லையும்
thamizhaiyum	தமிழையும்
thambadhi	தம்பதி
thambathi	தம்பதி
thampathi	தம்பதி
thambadhigalukku	தம்பதிகளுக்கு
thambathigalukku	தம்பதிகளுக்கு
thampathikalukku	தம்பதிகளுக்கு
thambadhigal	தம்பதிகள்
thambathigal	தம்பதிகள்
thambathikal	தம்பதிகள்
thampathikal	தம்பதிகள்
thambadhikku	தம்பதிக்கு
thambathikku	தம்பதிக்கு
thambadhiyinarukku	தம்பதியினருக்கு
thambathiyinarukku	தம்பதியின்க்குரு
thambadhiyinar	தம்பதியினர்
thambathiyinar	தம்பதியினர்
tayaaraanathu	தயாரானது
thayaaraanathu	தயாரானது
thayaranathu	தயாராணது
dayalan	டயலள்
dhayalan	தயலா்
thayaalan	தயாளன்
thayalan	தயலா்
tharakkoodiya	தரக்கூடிய
tharakkudiya	தரக்குடிய
tharakkuutiya	தரகூக்கிய
tharakutiya	தரகூட்டிய
tharakuutiya	தரகூடிய
tarataik	தரடைக்
tharathaik	தரதைக்
tharaththaik	தரத்தைக்
tharatthai	தரத்தை
tharavarisaip	தரவரிசைப்
tharavarisaiyil	தரவரிய்சையில்
tharavillai	தரவில்லை
tharavugalai	தரவுகளை
tharavukalai	தரவுகளை
tharavugalaith	தரவுகளைத்
tharavai	தரவை
tharuginraar	தருகின்றார்
tharukinraar	தருகின்றார்
tharukintraar	தருகின்றார்
tarunankalil	துருங்களில்
tharunangalil	தருணங்களில்
tharunankalil	தருணங்களில்
tharunankkalil	தருணங்களில்
tarunatthai	தருநாட்டை
tharunathai	தருநாதை
tharunaththai	தருநாத்தை
tharunatthai	தருநாத்தை
tarunamaka	தருணமாக
tharunamaaga	தருணமாக
tharunamaaka	தருணமாக
tharunamaka	தருணமாக
dharmapuri	தர்மபுரி
thalainagaram	தலைநகரம்
thalaynagaram	தலைநகரம்
thalaynakaram	தலைநகரம்
thalaimaiyidamaaga	தலைமையிடமாக
thalaimaiyidamaaka	தலைமையிடமாக
thalaimaiyidam	தலைமையிடம்
thalaimaiyaetroor	தலைமையொற்றூர்
thalaimaiyaettraar	தலைமையேற்றார்
thalaimaiyetraar	தலைமையீற்றா்
talaivanukku	தலைவனுக்கு
thalaivanukku	தலைவனுக்கு
talaivanum	தலைவனும்
thalaivanum	தலைவனும்
talaivanai	தலைவனை
thalaivanai	தலைவனை
talaivarai	தலைவரை
thalaivarai	தலைவரை
thala	தள
thalaththudan	தலத்துடன்
thalatthudan	தலத்துடன்
thalamaaga	தலமாக
thalamaaka	தலமாக
thalamaanadhu	தலமானது
thalamaanathu	தலமானது
thalamum	தரமும்
thalavaada	தலவாட
thalavaata	தலவாட
thalavaadangal	தலவாடங்கள்
thalavaadangkal	தலவாடங்கள்
thalavaadankal	தலவாடங்கள்
thalavaatankal	தலவாடங்கள்
vittathu	விய்த்து
vittatu	விட்டது
poadum	பட்டு
podum	பொடும்
potum	பொடும்
thavikkum	தவிக்கும்
thavil	தவில்
mudiyavillai	குடியவில்லை
mutiyavillai	குழ்யவில்லை
thaangak	தாங்கக்
thaangkak	தாங்கக்
thaankak	தாங்கக்
thaangakkoodiya	தாங்கக்கூடிய
thaangakkuudiya	தாங்கக்கூடிய
thaangkakoodiya	தாங்ககூடிய
thaankakkoodiya	தாங்கக்கூடிய
thaankakkuudiya	தாங்கக்கூடிய
thangakudiya	தங்ககுடிய
thaangal	தர்நகள்
thaangkal	தரங்கள்
thaankal	தரங்கள்
thaangaamal	தாங்காமல்
thaangkaamal	தாங்காசல்
thaankaamal	தாங்காமல்
dasan	தானன்
dhaasan	தாசன்
thaasan	தாசன்
manal	மண்
thaadhu	தானு
thaathu	தாது
thaadhup	தாதுப்
thaathup	தாதுப்
thaamiram	தாமிரம்
thamiram	தமிரம்
thaamboolam	மாத்பூலம்
thambulam	தம்புலம்
thaayagamaana	தாயகமான
daara	தரா
dara	தரா
taara	தரா
tara	தரா
taraa	தராக்
tarra	தடிற
thaaraa	தாரா
thara	தரா
thaaraavin	தாராவின்
tharavin	தரவின்
taliban	தலிபான்
talibangal	தலிபாங்கள்
thittamida	திட்டமிட
thittamidal	திட்டமிடல்
thittamidum	திட்டமிடும்
dmk	டிம்க
thimuka	திமுக்க
dmkvin	டிமைக்
thimukavin	திமுகவின்
thiyaagaraaja	தியாகராசா
thiyaakaraaja	தியாகராசா
thyaagaraja	தியாகரா
thiyaakaraajan	தியாகராஜன்
thiyagarajan	தியாகராசன்
thyaagarajan	தியாகரன்
thiyaagaraajar	தியாகராசர்
thiyaakaraajar	தியாகராசர்
thiyakarajar	தியாகராசர்
tiyaakaraajar	தியாகராசர்
thiruchchiraappalli	திருச்சிறப்பளளை
tiruchchirappalli	திருச்சிறப்பளிளை
thiruchchiraappalliyil	திருச்சிறாப்பிலல்ல்
tiruchchirappalliyil	திருச்சிறப்பளில்
thirumangai	திருமங்கை
thirumangkai	திருமங்கை
thirumangaiyaalvaar	திருமைங்காயவரலல்
thirumangaiyaazhvaar	திருமங்கையாலர்
thirumangkaiyazhvar	திருமங்கையாவர்
thirumaalin	திருமாளின்
thirumalin	திருமளின்
thirumulukku	திருமுழுக்கு
thirumuluku	திருமுழுக்கு
tirumulukku	திருமுழுக்கு
thiruvarangam	திருவரங்கம்
thiruvarangkam	திருவரங்கம்
thiruvarankam	திருவரங்கம்
tiruvarankam	திருவரங்கம்
thiruvaadaanai	திருவானவை
thiruvadanai	திருவடணை
thiraikku	திரைக்கு
thiraiku	திரைக்கு
tiraikku	திரைக்கு
thiraikkup	திரைக்குப்
thiraikup	திரைக்குப்
tiraikkup	திரைக்குப்
thiraith	திரைத்த
tiraith	திரைத்
thiraiyin	திரையின்
thirayin	திரையின்
tiraiyin	திரையின்
thira	திர
tira	திரா
thiranum	திரனும்
mikka	மிக்க
thiran	திரன்
thiranankalaiyum	திறனங்களையும்
thirangalaiyum	திறங்களையும்
thirankalaiyum	திறங்களையும்
thirangal	திறங்கள்
thirankal	திறங்கள்
theettappatta	தீட்டப்பட்ட
theettappattullathu	தீட்டப்பட்டுள்ளது
theendaamai	தீண்டாமை
dheeni	தினி
theeni	தேனி
deepak	பீதக்
deepaq	தீபா்
dheepak	தீப
diipak	ீதீகப்
theepak	தீப
tiipak	தீபா்
deebanggal	தீபங்கள்
deepanggal	தீபங்கள்
deepankal	பீபங்கள்
theepangal	தீபங்கள்
theepangkal	தீபங்கள்
deepan	தீபான்
dheepan	தீபன்
theepan	தீபன்
dheergadarisi	தீர்காடசிரி
theerkkatharisi	தீர்க்கத்தரி
theerppaayam	தீர்ப்பாயம்
theerppaal	தீர்ப்பாள்
theerppin	தீர்ப்பின்
theermaaniththanar	தீர்மானித்தனர்
thuduppu	தூடுப்ப
thudaippam	துடைப்பா்
thunindhu	துனிந்து
thuninthu	துனிந்து
thunburuthal	துன்புதுதல்
thunburuththal	துன்புருத்தல்
thunpuruththal	துன்புருத்தல்
thuruvak	துருவக்
thuruvam	துருவம்
dhroanar	திரோனர்
dronar	டிரோனர்
thuronar	ுரோதன்
dhurkkai	துருக்கை
durgai	துர்கை
durkkai	மர்்
thuravi	துறவி
thuravigalin	துறவிகளின்
thuravikalin	துறவிகளின்
thuraigal	துரைகள்
thuravigal	துவதிகள்
thuravikal	துவதிகள்
thuraviyin	துறவியின்
thuraiviyum	துறையிடும்
thuraviyum	துறவியும்
thuraikkum	துரைக்கும்
thulai	களை
thilaigalai	திலைகளை
thulaigalai	குலைகளை
thulaikalai	குலைகளை
thulaigal	துளைகள்
thulaikal	துளைகள்
thulaiththu	துளைத்து
thulaithu	துளை
thulaiyin	துளையின்
thulaiyil	துளையில்
thulaiyai	குளையை
thuvakathil	துவகத்தில்
thuvakkaththil	துவக்கத்தில்
thuvakkappattu	துவக்கப்பட்டு
thuvakamaga	துவகமாக
thuvakkamaaga	துவக்கமாக
thuvakkamaaka	துவக்கமாக
thuvakkam	குவக்கமச்
thuvangapata	துவங்கப்பட்ட
thuvangappatta	துவங்கப்பட்ட
thuvanggappatta	துவங்கப்பட்ட
thuvangkappatta	துவங்கப்பட்ட
thuvangavillai	துவங்கலவிலை
thuvanggavillai	துவங்களவில்லை
thuvangkavillai	துவங்கலவிலை
thoodhu	தூடு
thoothu	தூட்ட
doordarshan	டுராரசன்
doordharshan	ருத்சரீன்
thoortharshan	தூர்த்தரன்
thoolaith	தோலைத்து
thuulaith	துளை
therigiradhu	தேரிக்கிறது
therigirathu	தேரிக்கிறது
therkaaga	தெற்காக
therkaaka	தெற்காக
therkkaaka	தெற்காக
therkilirunthu	தெற்கிலிருந்து
therkkilirundhu	தெற்கிலிருந்து
thaekka	தெக்க
thekka	தேக்கா
thaengaip	தேங்கைப்
thaenkaaip	தென்பாய்
thengaip	தென்பைப்
thaer	தேரர்
ther	தேர்
thaerndhedukkum	தேர்ந்தெடுக்கும்
thaernthedukkum	தேர்ந்தெடுக்கும்
thernthedukkum	தேர்ந்தெடுக்கும்
thaervin	போர்த்
thervin	தர்தின்
thaervil	பேர்தில்
thervil	தர்வேல்
thaervai	போர்வை
thervai	தர்வே
devalaya	தேவளய
thevaalaya	தேவாளை
devaalayam	தேவாளம்
devalayam	தேவாாய்
thevaalayam	தேவாளயம்
deviyar	தேவியர்
theviyar	தேவியார்
thoguththa	தொடுத்த
thoguththaar	தொகுத்தார்
thoguppin	தொகுப்பின்
thokupin	தொகுப்பின்
thokuppin	தொகுப்பின்
thoguppilum	தொகுப்பிலும்
thokupilum	தொகுப்பில்
thokuppilum	தொகுப்பிலும்
thoguppil	தொகுப்பில்
thokupil	தொகுப்பில்
thokuppil	தொகுப்பில்
thoguppaiyum	தொகுப்பையும்
thokupaiyum	தொகுப்பையும்
thokuppaiyum	தொகுப்பையும்
thogaigal	தொகைகள்
thokaikal	தொகைகள்
tokaikal	தோக்கைகள்
thogaikku	தொகைக்கு
thokaikku	தொகைக்கு
thokaiku	தொகைக்கு
thogaiyaanthu	தொகையானது
thokaiyaanathu	தொகையானது
thokaiyanathu	தொகையதனது
thogaiyin	தொடையின்
thokaiyin	தொகையின்
tokaiyin	டுகையின்
thogaiyee	தொகையே
thokaiye	தொடையே
thokaiyee	தொகையே
thogaiyai	தொடையை
thokaiyai	தொடையை
tokaiyai	பொடையை
thokaiyaik	தொடையைக்
tokaiyaik	டோயைகைக்
thoda	ோட்ட
thota	தோட்டா
thodaraana	தொடரான
thodarukku	தொடருக்கு
thodarbukalil	தொடர்புகளில்
thodarpukalil	தொடர்புகளில்
thotarpukalil	தொடர்புகளில்
totarpukalil	தொடர்புகளில்
thodarbukalum	தொடர்புகளும்
thodarpukalum	தொடர்புகளும்
thotarpukalum	தொடர்புகளும்
totarpukalum	தொடர்புகளும்
thodarbugalaiyum	தொடர்புகளையும்
thodarbukalaiyum	தொடர்புகளையும்
thodarpukalaiyum	தொடர்புகளையும்
thodarbugal	தொடர்புகள்
thodarbukal	தொடர்புகள்
thodarpukal	தொடர்புகள்
thodarbukku	தொடர்புக்கு
thodarpukku	தொடர்புக்கு
thodarbudan	தொடர்புடன்
thodarpudan	தொடர்புடன்
thodarbuth	தொடர்புத்
thodarputh	தொடர்புத்
thodumpoothu	தொடும்போது
thodumpothu	தொடும்போது
thotumpothu	தொடும்போது
thottu	தொடு
thotu	தொடு
tholainokki	தொலைநோக்கி
tholainookki	தொலிலொங்கை
tholainokkiyai	தொலைநோட்கியை
tholainookkiyai	தொலைநோட்கியை
tholaipaesi	தொலைப்பேசி
tholaipesi	தொலைப்பிசி
tholaipaesialil	தொலைப்பேசிலில்
tholaipesigalil	தொலைப்பீசிலல்
tholaipesikalil	தொலைப்பீசிலல்
tholilin	தொழிலின்
thozhilin	தொழிலின்
tholilil	தொழிலில்
thozhilil	தொழில்ல்
tholuthaar	தொழுதார்
thozhuthaar	தொழுதார்
tholumpoathu	தொலும்போது
thozhumpoathu	தொழும்போது
thozhumpoothu	தொழும்போது
thozhumpothu	தொழும்போது
thoandum	தொடுடு
thondum	தொட்டும்
thoontum	தோட்டும்
thondriya	தோன்றிய
thontriya	தோன்றியா
thoontriya	தோன்றிய
thondriyadhaal	தோன்றியதால்
thondriyathaal	தோன்றியதால்
thontriyathal	தோன்றியதால்
thoontriyathaal	தோன்றியதால்
thondriyulladhu	தோன்றியுள்ளது
thondriyullathu	தோன்றியுள்ளது
thontriyulathu	தோன்றியுள்ளது
thoontriyullathu	தோன்றியுள்ளது
thoamas	தாவஸ்
thomas	தாவ்
dhoranai	தோரனை
thoaranai	தோரை
thoarruvikka	தோற்றுவிக்க
thoatruvikka	தோற்றுவிக்க
thoattruvikka	தோற்றுவிக்க
thoarruviththavar	தோற்றுவித்தவர்
thoatruviththavar	தோற்றுவித்தவர்
thoattruviththavar	தோற்றுவித்தா்
thoarruviththaar	தோற்றுவித்தார்
thoatruviththaar	தோற்றுவித்தார்
thoattruviththaar	தோற்றுவித்தார்
thoarruviththu	தோற்றுவித்து
thoatruviththu	தோற்றுவித்து
thoattruviththu	தோற்றுவித்து
thoalvikku	தோல்விக்கு
tholvikku	தோல்விக்கு
tholviku	தோல்விக்கு
thoolvikku	தூள்விக்கு
thoalvikkup	தோல்விக்குப்
tholvikkup	தோல்விக்குப்
tholvikup	தொல்விக்குப்
thoolvikkup	தூழ்விக்குப்
thoalviyil	தோல்வியில்
thoalviyae	தோல்விய
thoalviyaith	தோல்வியைத்
nagaraththaich	நகரத்தைச்
nadakkiradhu	நடக்கிறது
nadakkirathu	நடக்கிறது
nadaiperaadha	நடைபெறாத
nadaiperaatha	நடைபெறாத
nadiperaadha	நடிபெறாத
nadaiperaamal	நடைபெறாலம்
nadaiperuvadhai	நடைபெறுவதை
nadaiperuvathai	நடைபெறுவதை
moolaam	மூலாம்
moolam	மூல்
mulam	முறம்
nadhigalum	ததிகளும்
nadhigazhum	ததிகளும்
nadhikalum	ததிகளும்
nathigalum	நதிகளும்
nathikalum	நதிகளும்
nadhik	நதிக்
nathik	நதிக்
nadhiyaana	நதியான
nathiyaana	நதியான
nadhiyilirunththu	நதியிலிருந்து
nadhiyilirunthu	நதியிலிருந்து
nathiyilirunthu	நதியிலிருந்து
nadhiyil	நதியில்
nathiyil	நதியில்
nadhiyaiyum	நதியையும்
nadiyaiyum	அடியையும்
nathiyaiyum	நதியையும்
naththam	மத்தன்
nanmai	நன்மை
nannanmy	நண்னங்கி
nanmaigalai	நன்மைகளை
nanmaigazhai	நன்மைக்களை
nanmaikalai	நன்மைகளை
nanmaigalaip	நன்மைக்களைப்
nanmaigazhaip	நன்மைக்களைப்
nanmaikalaip	நன்மைக்களைப்
nanmaigal	நன்மைகள்
nanmaikal	நன்மைகள்
nanmaikaka	நன்மைக்காக
nanmaikkaaga	நன்மைக்காக
nanmaikkaaka	நன்மைக்காக
nanmaiyaaga	நன்மையாக
nanmaiyaaka	நன்மையாக
nanmaiyaka	நன்மையாக
nanmaiyae	நன்மையே
nanmaiyaiye	நன்மையையே
nanmaiyaiyee	நன்மையையே
nanmaiye	நன்மையே
nayathodu	மயோதடடடடடடடடோடோ
nayathotu	யயதோட்டு
nayaththoadu	மயத்தோடு
nayaththodu	மயத்தோடு
nayatthootu	மயத்தோடு
nayam	தாயம்
narachiman	நரசிமின்
narachimman	நரச்சிம்
narasimman	நறச்சிம்
narambugalai	நரம்புகளை
narambukalai	நரம்புகளை
narampukalai	நரம்புகளை
narambugal	நரம்புகள்
narambukal	மரம்புகள்
narampukal	மரம்புகள்
narpanbugal	நற்புங்கள்
narpanbugazh	நற்புன்பக்
narpanbukal	நற்பண்புகள்
narpanpukal	நற்புண்பா்
nala	நரா
nalla	நல்லா
vali	களை
vazhi	ளை
nallaar	ந்்ாளர்
nalloar	நள்ளோ
nalloor	ந்்ூரல்
nalor	நோற்
nalan	நரன்
naliravu	நல்வவற
nalliravu	நள்ளவரவு
nav	ந்தவ
nava	வர
naw	ந்தவ
nawa	வன
noa	றத்து
nov	ம்வு
now	ம்
navachakthi	நவசா்்ி
navasakthi	நவதாக்தி
navashakthi	நவதாக்தி
navami	மவவி
navam	நவர்
naveenath	நேவியத்தா
naveenaththuva	நேவிந்தவு
naveenaththuvam	நவியத்துவம்
naveenam	நவியம்
naveen	வனின்
naviin	வினின்
navin	வினின்
naween	வனின்
nawiin	வினின்
nawin	வினின்
naagareegangalil	நாகரரங்களில்
naagareegangazhil	நாகரரிகங்கள்
naagareeganggalil	நாகரரங்களில்
naagareegaththai	நாகரிக்கதை
naasaavin	வாசாவின்
nasavin	வசனின்
naasaavil	தாவாவில்
nasavil	நவரில்
naasi	நாய்
nasar	நாசர்
nasr	நார்
nasra	நரர்
naanchil	நான்சில்
nanchil	நஞ்சில்
nanjil	நஞ்சில்
naadukadaththa	நாடுகடதத
naadukadattha	நாடுகடதத
naadukadaththappatta	நாடுகடட்டத்தப்பட
naadukadatthappatta	நாடுகடட்டப்பட்ட
naadoadi	கோடை
naadodi	கோடடி
naadoodi	மொடி
naattavargal	நாட்டவர்கள்
naattavargazh	நாட்டவர்கள்
naattiya	நாட்டிய
naattiyaththil	நாட்டியத்தில்
naattiyap	நாட்டியப்
naana	வான
naanaa	வான
nana	நனது
nanaa	நான
naanooru	மானூறு
naaraayanaaya	நாராயணாயா
narayanaya	நாராயணியா
naarpathu	நார்பது
naarpathukkum	நார்பதுக்கும்
naatraththai	வாற்றத்தை
naattraththai	வாற்றத்தை
nigara	கிராக
nikara	நிராக
nigalthagavu	நிகழ்ததாகு
nigazhthagavu	நிகழ்ததாகு
nikazhthakavu	நிகழ்த்தகவு
nigalththa	நிகழ்த்த
nigazhththa	நிகழ்த்த
nikazhththa	நிகழ்த்த
nigalththappadum	நிகழ்த்தப்படும்
nigazhththappadum	நிகழ்த்தப்படும்
nikazhththappadum	நிகழ்த்தப்படும்
nigalvugalaal	நிகழ்வுகளால்
nigalvugazhaal	நிகழ்வுகளால்
nigazhvugalaal	நிகழ்வுகளால்
nikazhvukalaal	நிகழ்வுகளால்
nigalvugalin	நிகழ்வுகளின்
nigalvugazhin	நிகழ்வுகளின்
nigazhvugalin	நிகழ்வுகளின்
nikazhvukalin	நிகழ்வுகளின்
nigalvugalaip	நிகழ்வுகளைப்
nigalvugazhaip	நிகழ்வுகளைப்
nigazhvugalaip	நிகழ்வுகளைப்
nikazhvukalaip	நிகழ்வுகளைப்
nigalvugalaiyum	நிகழ்வுகளையும்
nigalvugazhaiyum	நிகழ்வுகளையும்
nigazhvugalaiyum	நிகழ்வுகளையும்
nikazhvukalaiyum	நிகழ்வுகளையும்
nigalvum	கிழ்வும்
nigazhvum	கிழவும்
nikazhvum	கிழவும்பு
nigalvai	கிழ்வவை
nigazhvai	நிகழ்வை
nikazhvai	நிகழ்வை
nigalvaip	கிணைவ்வுப்
nigazhvai	நிகழ்வை
nigazhvaip	கிழவவிப்
nikazhvaip	நிகழ்வைப்
nigalvaiyum	நிகழ்வையும்
nigazhvaiyum	நிகழ்வையும்
nikazhvaiyum	நிகழ்வையும்
nicotin	நிகோட்டின்
nicotine	நியோட்டின்
nikoatin	நிகோட்டின்
nesan	நேசன்
nessan	நேஸ்கன்
nisaan	நியான்
nisan	நியன்
nissan	ஸ்னான்
nissann	நிஸ்ணன்
ninaivaagavum	நினைவாகவும்
ninaivaakavum	நினைவாகவும்
niyamanam	நியமானம்
niyamika	நியமிக்க
niyamikka	நியமிக்க
nirubar	நிரூப்
nirupar	நிருப்பர்
nirvagikka	நிர்வகிக்க
nirvakikka	நிர்வகிக்க
nirvagikkum	நிர்வகிக்கும்
nirvakikkum	நிர்வகிக்கும்
nirvaaga	நிர்வாக
nirvaaka	நிர்வாக
nirvaagak	நிர்வாகக்
nirvaagangal	நிர்வாகங்கள்
nirvaaganggal	நிர்வாகங்கள்
nirvaagath	நிர்வாகத்
nirvaagaththirkum	நிர்வாகத்திற்கும்
nirvaagaththilum	நிர்வாகத்திலும்
nirvaakaththilum	நிர்வாகத்திலும்
nirvaagaththil	நிர்வாகத்தில்
nirvaagamum	நிர்வாகமும்
nirvaakamum	நிர்வாகமும்
nirvakamum	நிர்வகமம்
niraivurum	நிறைவுரும்
nilak	கிள்
nilakkadalai	நிலக்கடலை
nilainiruththa	நிலைநிருத்த
nilainiruththik	நிலைநிருத்திக்
nilainiruththum	நிலைநிருத்தும்
nee	நீய்
nii	கிய
neettik	நீட்டிக்
neettippu	நீட்டுப்பு
neethaan	தீதான்
neethu	தீரு
neetu	மீடிட
neeyae	நேயே
neeyea	நீய
neeraetram	நீரேற்றம்
neeraetrtram	நீரேற்றம்
neereatram	நீராய்றம்
neerai	மீரை
neeraith	நீரைத்த
neeraip	பீரைப்
neeraiyum	கீரையும்
naro	மறோ
nearo	மேோரோ
neero	மேோர்
neeroa	நேரோ
neeroo	மீரோ
nero	மேோரோ
neroo	மறையொ
niiro	இறோ
niiroo	மறைறு
niro	மொரோ
niroo	கிரோ
neeroadu	மீரோடு
neeroattanggal	நேரோட்டங்கள்
neeroattangkal	நேரோட்டங்கள்
neeroattankal	நேரோட்டங்கள்
neeroattaththin	நேரோத்டத்தின்
neeroattaththil	நேரோத்டத்தில்
neeroattam	நீரோட்டம்
neerroattam	நேரோட்டம்
neermattam	நீர்மடத்தி
neervala	நீர்வழ
neervalam	நீர்வலம்
nun	ந்து
nunmai	நுன்மை
nuraiyeeralin	நுரையீரலின்
nuraiyiiralin	நுரையிரலின்
nuraiyeeralil	நுரையீரல்ல்
nuraiyiiralil	நுரையீரல்ல்
nuraiyeeral	நுரையீரல்
nuraiyiiral	நுரையீரல்
nulainththa	நுழைந்த
nuzhaindha	நுழைந்த
nuzhinththa	நுழைந்த
nulainthathaal	நுழைந்ததால்
nuzhaindhadhaal	நுழைந்ததால்
nuzhinththathaal	நுழைந்ததால்
nulainthathu	நுழைந்தது
nuzhaindhadhu	நுழைந்தது
nuzhinththathu	நுழைந்தது
nulainththathum	நுழைந்ததும்
nuzhaindhadhum	நுழைந்ததும்
nuzhinththathum	நுழைந்ததும்
nulainthana	நுழைந்தன
nuzhaindhana	நுழைந்தன
nuzhinththana	நுழைந்தன
nulainththanar	நுழைந்தனர்
nuzhaindhanar	நுழைந்தனர்
nuzhinththanar	நுழிந்தனர்
nulainthapoathu	நுழைந்தபோது
nuzhaindhapoadhu	நுழைந்தபோது
nuzhinththapoathu	நுழைந்தபோது
nulainththaar	நுழைந்தார்
nuzhaindhaar	நுழைந்தார்
nuzhinththaar	நுழைந்தார்
nootriyettu	நூற்றியட்டு
nootrtriyettu	அறைற்றிய்து
noottriyettu	அறைற்றிய்து
noolaga	நூலாக
noolaka	நூலாக
noolagangalil	நூலங்களில்
noolagangkalil	குழனங்களில்
noolakangalil	நூல்கங்களில்
noolakangkalil	நூலங்களில்
noolagangal	குழனங்கள்
noolagangkal	குழனங்கள்
noolakangal	நூலங்கள்
noolakangkal	நூலங்கள்
noolagath	கொலப்பட்
noolakath	நோலகத்
noolagaththirku	கொழுதத்திற்கு
noolakaththirkku	நூலத்திற்கு
noolakaththirku	நூலத்திற்கு
noolagaththil	கொலத்தில்
noolakaththil	நூலகத்தில்
noolagaththai	கொலைக்கத்
noolakaththai	கொலைக்கத்தி
noolagamum	கொலமாகும்
noolakamum	கொலமாகும்
noolum	மூல்
noolae	நூல்
noole	நூல்
neduncheralathan	நெடுஞ்சாலந்தில்
nedunjchaeralaathan	நெடுஞ்செலத்தாலை
nedunjeralaadhan	நெடுஞ்செலதானன்
nedunjeralaathan	நெடுஞ்செலதானன்
nerippaduththum	நெரிப்படுத்தும்
nerri	ஏறி
netri	நெட்ரி
nettri	நேதிரி
netrip	நெத்திப்
nettrip	நெத்திப்
nelsan	நெல்சன்
nelson	நெல்சொன்
naeyargal	நயர்கள்
neyargal	நேயர்கள்
neyarkal	நேயர்கள்
neerittathu	நேரிடத்து
neritathu	நேரிடத்து
nerittadhu	நேரிடத்து
nerittathu	நேரிட்டது
neerittaal	நேரிட்டல்
nerital	நேரிடல்
nerittaal	நேரிட்டால்
naooyda	அவ்த்தி
noida	நோய்ட
noidaa	நோய்தா
noyda	தோட்டா
noyta	இயூய்
noytaa	தொயதா
noakki	மோக்கி
nokki	மோக்கி
noakkith	நோக்கித்
nokip	நோகிப்
nokkip	மொக்கிப்
nookkip	போக்கிப்
nokiye	நோக்கியி
nokkiye	நோக்கியி
nookkiyee	நோக்கியே
nokil	நோக்கில்
nokkil	கொக்கில்
nookkil	கோக்கில்
nooyinai	மோயினை
noyinai	நோயினை
noaiththotru	தொயொத்தூரு
noayththotru	தொய்தொட்ரூர்
noiththottru	தொய்தொட்டிரு
pagadai	படுகை
pakadai	பகதாவை
baka	பக
bakaa	பகா
bhaga	பகத்
pakaa	பகா
bhageerathan	பகேரதன்
pakeerathan	பகேரத்தின்
pakiirathan	பகிரதன்
pakirathan	பகிரதன்
paguthiyaith	பகுதியைத்
pakuthiyaith	பகுதியைத்
paguppaaivu	பகுப்பாவு
paguppaayvu	பகுப்பாவு
pakuppaaivu	பகுப்பாவுவை
pangkuthaarar	பங்குதரார்
panguthaarar	பங்குதார்
pankuthaarar	பங்குதார்
pankutharar	பங்குதர்
panguthaarargalaaga	பங்குத்தாரர்களாக
panguthaararkalaaka	பங்குத்தாரராக
panguthararkalaka	பங்குதர்களாக
pankuthaararkalaaka	பங்குத்தாரராக
bangkuthaararkalin	பங்குதாரங்களின்
panguthaarargalin	பங்குதாரங்களின்
pankuthaararkalin	பங்குதாரங்களின்
pankuthararkalin	பங்குதரங்களின்
bangkuthaararkal	பங்குதர்களார்
panguthaarargal	பங்குத்தாரர்
pankuthaararkal	பங்குதார்கள்
pankuthararkal	பங்குதர்கள்
pasukkalin	பசுக்களின்
pasukkazhin	பசுக்களின்
pasukkalil	பசுக்களில்
pasukkazhil	பசுக்களில்
pasukkal	பசுக்கல்
padangalin	படங்களின்
padangkalin	படங்களின்
pandangalin	பண்டங்களின்
padangalilum	பட்டங்களிலும்
padangkalilum	படங்களிலும்
pandangalilum	பண்டங்களிலும்
padangalukkum	பட்டங்களும்
padanggalukkum	படங்களுக்கும்
padangaludan	படங்களுடன்
padanggaludan	படங்களுடன்
padappidippu	படப்பிடிப்பு
padappidippugal	படப்பிடிப்புகள்
padappidippukal	படப்பிடிப்புகள்
padarndhu	படர்ந்து
padarnththu	படர்ந்து
padarnthu	படர்ந்து
padala	கடளை
padalangal	படலாங்கள்
padalankal	படளங்கள்
padalaththil	படளத்தில்
padigalin	படிகளின்
padikalin	படிகளின்
padigal	படிகள்
padikal	படிகள்
padikku	படிக்கு
poluthu	பொழுது
polutu	பொழுட்டு
pozhuthu	பொழுது
padidhal	படிதல்
padithal	படித்தால்
padinilai	படினிலை
padinilaigalil	படினுள்களில்
padinilaikalil	படினுள்களில்
padipai	படிப்பை
padippai	படிப்பை
patippai	படிப்பை
padipaith	படிபைப்
padippaith	படைப்படி
patippaith	படைப்படி
padipaiyum	படிபையும்
padippaiyum	படிப்பையும்
patippaiyum	படிப்பையும்
padimangalai	படிமங்களை
padimangazhai	படிமனங்களை
padimankalai	படிமங்களை
patimankalai	படிமங்களை
padimathin	படிமத்தின்
padimaththin	படிமத்தின்
padimatthin	படிமத்தின்
patimatthin	படிமத்தின்
padimam	படிமம்
patimam	படிமம்
padiyil	படியில்
patiyil	படியில்
paduthiya	படுதிய
paduththiya	படுத்திய
padutthiya	படுத்திய
patuthiya	படுதிய
paduthiyathu	படுத்தியது
paduththiyadhu	படுத்தியது
paduththiyathu	படுத்தியது
padutthiyathu	படுத்தியது
patutthiyathu	படுத்தியது
paduththiyulladhu	படுத்தியுள்ளது
paduththiyullathu	படுத்தியுள்ளது
padaithathu	படைத்து
padaiththathu	படைத்தது
padaitthathu	படைத்தது
pataitthathu	படைத்தது
padaithanar	படைத்தனர்
padaiththanar	படைத்தனர்
padaitthanar	படைத்தனர்
pataitthanar	படைத்தனர்
padaithalapathi	படைத்தளப்படி
padaiththalapathi	படைத்தளத்தை
padaitthalapathi	படைத்தளத்தை
pataitthalapathi	படைத்தளத்தை
padaithan	படைத்தான்
padaiththaan	படைத்தான்
padaitthaan	படைத்தான்
pataitthaan	படைத்தான்
padaiththu	படைத்து
padaithu	படைத்து
padaitthu	படைத்து
pataitthu	படைத்து
padaipaka	படைப்பாக
padaippaakka	படைப்பாக்க
padaippakka	படைப்பக்க
pataippaakka	படைப்பாக்க
padaiyinarum	படையினரும்
pataiyinarum	படையினரும்
pattathu	பட்டது
panayak	பணவை
panigalin	பணிகளின்
panigazhin	பணிகளின்
panigalukku	பணிகளுக்கு
panigazhukku	பணிகளுக்கு
panigalukkup	பணிகளுக்குப்
panigazhukkup	பணிகளுக்குப்
panigalukkum	பணிகளுக்கும்
panigazhukkum	பணிகளுக்கும்
panigalum	பனிகளும்
panigazhum	பணிகளும்
panigalai	பணிகளை
panigazhai	பணிக்களை
panigalaip	பணிகளைப்
panigazhaip	பணிகளைப்
panigalaiyum	பணிக்களையும்
panigazhaiyum	பணிக்களையும்
panigal	பனிகள்
panigazh	பணிகள்
panikkaana	பணிக்கான
panithan	பனித்தன்
paniththaan	பணித்தான்
panitthaan	பணித்தான்
panimanai	பனிமனை
paniyaanadhu	பணியானது
paniyaanathu	பணியானது
paniyin	பணியின்
paniyilirindhu	பணியிலிருந்து
paniyilirunthu	பணியிலிருந்து
paniyilum	பணியிலும்
paniyum	பணியும்
panpaadu	பண்பாடு
panbaadugalin	பண்பாடுகளின்
panpaadugalin	பண்பாடுகளின்
panpaadugazhin	பண்பாடுகளின்
panpaadukalin	பண்பாடுகளின்
panbaadum	பண்பாடும்
panpaadum	பண்பாடும்
padhikkappatta	பாதிக்கப்பட்ட
pathikkappatta	பாதிக்கப்பட்ட
padhinaezhyaam	பதினையிலம்
pathinaelaam	பதினேலாம்
pathinaezhaam	பதினேழாம்
pathinealaam	பதினேலாம்
pathineazhaam	பதினேழாம்
pathinezhaam	பதினேழம்
padhinoaraavadhu	பதினோனாவது
pathinaoraavathu	பதினாறாவது
pathinoaraavathu	பதினோராவது
padhippiththa	பதிப்பித்த
pathippiththa	பதிப்பித்த
pathippittha	பதிப்பித்த
padhippiththullaar	பதிப்பித்துள்ளார்
pathippiththullaar	பதிப்பித்துள்ளார்
pathippitthullaar	பதிப்பிட்துள்ளார்
padhulaiyil	பதித்லை
pathulaiyil	பதுதிலையி
paththaandu	பத்தாண்டு
paththaandugalaaga	பத்தான்குகளாக
paththaandukalaaka	பத்தான்டுகளாக
paththaandugalil	பத்தான்டுகளில்
paththaandukalil	பத்தான்டுகளில்
paththaandugal	பத்தான்டுகள்
paththaandukal	பத்தான்டுகள்
padmanaaban	பட்மனானன்
pathmanaaban	பத்தனாஜன்
pandhiyil	பந்தியில்
panthiyil	பந்தியில்
panththiyil	பந்தியில்
panimalai	பனிமளை
pannirandaam	பன்னிரண்டாம்
pannirendaam	பன்னிரண்டாம்
pannirendu	பன்னிணர்து
pandri	பன்றி
panri	பன்றி
pandrikalin	பன்றிகளின்
panrigalin	பன்றிகளின்
panrikalin	பன்றிகளின்
pandrikalai	பன்றிகளை
panrigalai	பன்றிகளை
panrikalai	பன்பிகளை
pandrikal	பன்றிகள்
panrigal	பன்றிகள்
panrikal	பன்றிகள்
pandriyin	பான்றியின்
panriyin	பெர்வியின்
bambaram	பம்பரம்
pambaram	பம்பரம்
pamparam	பம்பரம்
cet	கெட்டி
pamp	பம்
pump	பம்
puump	பூம்
set	சத்தியா
payanamaanaar	பயனமானார்
payaniththu	பயநித்து
payanithu	பயநிது
payanpaduththavillai	பயன்படுத்தவில்லை
payanpaduththuvathai	பயன்படுத்துவதை
payanpaduthuvathai	பயன்படுத்துவதை
payanpatuththuvathai	பயன்படுத்துவதை
payir	பேயர்
payirgalin	பயிற்கின்
payirkalin	பயிற்களின்
payirgalil	பயிற்களில்
payirkalil	பயிற்களில்
payirgalukku	பயிற்குள்கு
payirkalukku	பயிற்களுக்கு
payirgalum	பயிற்கும்
payirkalum	படிற்களும்
paiyrkalaith	பைரிக்களை
payirgalaith	பயிற்களைதை
payirkalaith	பயிற்களைதை
paiyrch	பைதிற்க
payirch	பயிற்
baiylvaan	பைல்வான்
bayilvaan	பயில்வான்
paiylvaan	பைல்வான்
payilvaan	பயில்வான்
barathaechi	பரதேசி
paradesi	படதெய்
paradhesi	பரதேசி
parathaechi	பரதேசி
parathesi	பரதேசி
parapalavai	பரபலவை
parappalavai	பரபலவைை
parappazhavai	பரப்பவவை
parappurai	பரப்புறை
parappuraigalai	பரப்புறைகளை
parappuraigazhai	பரப்புறைகளை
parappuraikalai	பரப்புறைகளை
parichoathiththu	பரிசோதததது
parisoathiththu	பரிசோதததி
parimaatraththil	பரிமாட்டத்தில்
parimaattraththil	பிராமாறத்தில்
parimaatraththai	பரிமாட்டத்தை
parimaattraththai	பிராமாற்றத்தை
parimaatramum	பிராம்றுறம்
parimaattramum	பிராமாற்றும்
parumanaal	பருமானல்
paruman	பருமன்
barnaalaa	பர்நாளா
barnala	பர்னலா
parnaalaa	பர்னாலான
parikka	பரிக்க
parikkum	பரிக்கும்
palagaigal	பலகைகள்
palagaikal	பலகைகள்
palakaikal	பலகைகள்
palagaiyin	பலகையின்
palakaiyin	பலகையின்
palagaiyil	பலையில்
palakaiyil	பலகையில்
balaththa	பழத்த
palaththa	பழத்த
palaridam	பலரிடம்
palavaaraaga	பலவாறவை
palavaaraaka	பலவாறவை
paliyiduthal	பாலியுடி்
paliyiduvathu	பாலியுடிவது
pallavargal	பல்வர்கள்
pallum	பள்ளும்
balu	பல
palu	பல்ல
pazhu	பழு
bharathi	பரதி
palani	பழனி
parati	பரடி
pazhani	பழனி
pazhu	பழு
pazhavaettaraiyar	பழவேந்தேரையார்
pazhuvettaraiyar	பழுவிட்டராயர்
pavi	பவி
paula	போல
paulaa	போல
pauula	போல
pauulaa	போலா
pavula	பவுள்ள
poola	போல
pula	போர
paakisthaanukku	பாகிஸ்தானுக்கு
pakistanukku	பாகிஸ்துன்கு
pakisthanukku	பாகித்துங்கு
paagupaadu	பாகுபாடு
paakupaadu	பாகுபாடு
paagupaadum	பாகுபாடும்
paakupaadum	பாகுபாடும்
baacyaraaj	பாச்சாரா்
baagyaraaj	பாகிராஜ்
baakkiyaraaj	பாக்கிரியாக
baakyaraaj	பாக்ரியார்
bagyaraj	பகரோஜ்
bakyaraaj	பாகிராஜ்
bhakkiyaraaj	பக்ரியாகர்
baangaak	பார்காக்
baangkaak	பார்காக்
bangkok	பங்கே
bangqoq	பங்கே
pankak	பங்கக்
paandavargalil	பாண்டவர்களில்
paandavarkalil	பாண்டவர்களில்
paantavarkalil	பாண்டவர்களில்
pandavargalil	பண்டவர்களில்
paandavargalukkum	பாண்டவர்களுக்கும்
paandavarkalukkum	பாண்டவர்களுக்கும்
paantavarkalukkum	பாண்டவர்களுக்கும்
pandavargalukkum	பண்டவர்களுக்கும்
paandavargalum	பாண்டவர்களும்
paandavarkalum	பாண்டவர்களும்
paantavarkalum	பாண்டவர்களும்
pandavargalum	பண்டவர்களும்
paandavargalai	பாண்டவர்களை
paandavarkalai	பாண்டவர்களை
paantavarkalai	பாண்டவர்களை
pandavargalai	பண்டவர்களை
paandavargal	பாண்டவர்கள்
paandavarkal	பாண்டவர்கள்
paantavarkal	பாண்டவர்கள்
pandavargal	பண்டவர்கள்
baathagaththai	பாதகத்தை
paathagaththai	பாதகத்தை
paathakaththai	பாதகத்தை
baathip	பதிப்
paathip	பதிப்
paadhiyaaga	பாதியாக
paathiyaaka	பாதியாக
paadhiyil	பாதியில்
paathiyil	பாதியில்
baathai	பதை
paathai	பதை
baathaikalin	பாதைகளின்
paathaikalin	பாதைகளின்
baathaikalum	பாதைகளும்
paathaikalum	பாதைகளும்
baathaikalai	பாதைகளை
paathaikalai	பாதைகளை
baathaaikku	பாதாய்க்கு
paathaaikku	பாதாய்க்கு
paathaikku	பதைக்கு
paathaiyil	பாதையில்
paathaiyai	பதையை
paathaiyaik	பாதையைக்
paathaiyaip	பாதையைப்
baanangal	பாரங்கள்
baanangkal	பாரங்கள்
baanankal	பானங்கள்
paanankal	பானங்கள்
baanaththil	பானத்தில்
paanaththil	பானத்தில்
baanaththai	பானத்தை
paanaththai	பானத்தை
baanam	பானம்
paanam	பானம்
baabaavin	பாவாவின்
babeel	பேல்
babel	பெல்
baebal	பேபா்
baebel	பேபில்
baeebal	பீரல்
baeebeel	பேபில்
beeybalee	பெயலேபி
beibale	பெர்லா
beybale	பெலலே
papeel	பேரில்
baarathiya	பாரதிய
bhaarathiya	பாரதிய
bharathiya	பரதிய
baarathiyaar	பாரதியார்
bhaarathiyaar	பாததியார்
bharathiyaar	பரதியார்
paariya	பாரிய
paariyalavilaana	பாரியவாளியான
baaru	பறு
paaru	பறு
paarkkum	பர்க்கும்
paalum	போலும்
paaluravu	பாலரவவு
paalootti	போலட்டி
paaluutti	போலூட்டி
paaloottigalil	போலட்டிகளில்
paaloottikalil	போலத்திகள்
paaluuttigalil	பாலுத்திகள்
paaluuttikalil	பாலுத்திகள்
paaloottigal	போலட்டிகள்
paaloottikal	போலத்திகள்
paaluuttigal	பாலுத்திக்
paaluuttikal	பாலுத்திக்
paal	பாள்
paazh	பாழ
baava	பவர்
bhaava	பவர்
paava	பவர்
bhaavangalukku	பாவங்களுக்கு
paavangalukku	பாவங்களுக்கு
paavangkalukku	பாவங்களுக்கு
paavankalukku	பாவங்களுக்கு
bhaavangal	பாவங்கள்
paavangal	பாவங்கள்
paavangkal	பாவங்கள்
paavankal	பாவங்கள்
baavanai	பாவனை
bhaavanai	பாவனை
paavanai	பாவனை
baavanaiyil	பாவனையில்
bhaavanaiyil	பாவனையில்
paavanaiyil	பாவனையில்
bisin	பிசன்
pichin	பிசின்
pisin	பிசின்
pithappai	பிதப்பை
piththappai	பித்தப்பை
bindhu	பிந்து
pinthu	பிந்து
pinbura	பின்புற
pinpura	பின்புற
pinburamaaka	பின்புறமாக
pinpuramaaga	பின்புறம்
pinpuramaaka	பின்புறம்
binvaanginaar	பின்வாங்கினார்
binvaangkinaar	பின்வாங்கினார்
pinvaanginaar	பின்வாங்கினார்
pinvaangkinaar	பின்வாங்கிறான்
pigmees	பிரிக்
pigmies	பிமிக்
pygmees	பிக்ஸ்
pygmies	பிமிக்
pygmiis	பிச்மி
pyjmees	பிசிஸ்
pyjmies	பிசிம்ஸ்
pirachaara	பிரசாரா
pirasaara	பிரசாரா
prachaara	பிரசாரா
pirachaaram	பிரசாசார்
pirasaaram	பிரசாரம்
prachaaram	பிரச்சார்
pirachurankal	பிரச்சுறங்கள்
pirasurangal	பிரசுருங்கள்
pirasurangkal	பிரசுரங்கள்
prachurankal	பிரச்சுறங்கள்
prasurankal	பிரசுரங்கள்
pirachuram	பிரச்சுறும்
pirasuram	பிரசுருச்
prachuram	பிரச்சுறும்
prasuram	பிரசுரம்
piradhaanap	பிரதானன்
pirathaanap	பிரதானன்
piradhaanamaaga	பிரதானமாக
pirathaanamaaka	பிரதானமாக
piradhaanamaana	பிரதானமான
pirathaanamaana	பிரதானமான
piraththiyaekamaaka	பிரத்தியேகமாக
pirathyaekamaaka	பிரதீசமயகம்
pirathyeagamaaga	பிதிரியமாக
piraththiyaekamaana	பிரத்தியேமாக
pirathyaekamaana	பிரதியகமமாசன
pirathyeagaamana	பிரதியாகமான
cankar	கங்கர்
pirapu	பிரபு
prabhoo	பிரபோ
prabhu	பிரபு
prabhuu	புறபு
prabu	பிரபு
prabuu	பிரபு
sangkar	சங்கர்
sankar	சங்கர்
shankar	சங்கர்
pirabhukkal	பிரபுகள்
pirabukkal	பிரபுகள்
prabukkal	பிரபுகள்
pirabhuvin	பிரபுவின்
pirabuvin	பிரபுவின்
prabhuvin	பிரபுவின்
prabuvin	பிரபுவின்
probuvin	புரோபின்
bhramma	பிரம்மா
biramma	பிரம்மா
brahma	பொரமா
brahmma	பிரம்மா
bramma	பொரம்மா
piramma	பிரம்மா
brammaththai	பிரம்மத்தை
pirammaththai	பிரமம்ததை
brammanai	பிரம்மணை
pirammanai	பிரம்மைை
brammam	பிரம்மாம்
pirammam	பிரம்மா
pirammum	பிரம்மும்
piraveen	பிரவேன்
praveen	பிரவின்
piravaecha	பிரவேச
piravaesa	பிரவேச
piravesa	பிரவேச
pravaesa	பிரவேச
braamanargalum	பிரமமான்கள்
braamanarkalum	பிரமமான்கள்
piraamanarkalum	பிராமரங்களும்
praamanarkalum	பிராமரங்களும்
piritha	பிரித்த
piriththa	பிரித்த
priththa	பிரித்த
pirithanar	பிரித்தனர்
piriththanar	பிரித்தனர்
priththanar	பிரித்தனர்
pirithaar	பிரித்தார்
piriththaar	பிரித்தார்
priththaar	பிரித்தார்
pirivinarae	பிரிவிரான
privinarae	பிரிவினரை
piraemaa	பிரமே
praemaa	பிரமா
prema	பீரம்
premaa	பிரமா
piraem	பிரே
pireem	பிரியம்
praem	பிர்
praim	பிரை்
preeim	பிரியம்
preem	பிர்டு
preemm	பிரீம்
preim	பிரியம்
prem	பிரும்
premm	பிரம்
talankalil	தளங்களில்
thalanagalil	தளங்களில்
thalangalil	தளங்களில்
thalangkalil	தளங்களில்
pirandhadhaaga	பிறந்ததாக
piranthathaaka	பிறந்ததாக
pirandhadhaal	பிறந்ததால்
piranthathaal	பிறந்ததால்
pirandhadhu	பிரந்தது
piranthathu	பிரந்தது
pirandhana	பிரந்தன
piranthana	பிறந்தன
pirandhanar	பிறந்தனர்
piranthanar	பிறந்தனர்
pirandhapoadhu	பிற்்பநோது
piranthapoathu	பிறந்தபோது
piranthapoothu	பிறந்தபோது
piranthavudan	பிறந்தவுடன்
piranthavutan	பிறந்தவுடன்
piranthavai	பிறந்தவை
vittaal	கிட்டா்
vittal	விட்ட
piranthirullathu	பிறந்திருள்ளது
piranthullathu	பிறந்துள்ளது
pirappai	பிரப்பை
pirarukku	பிரருக்கு
piraroadu	பிரடோடு
piraroatu	பிரடோது
piraroodu	பிரெரு
pirkaala	பிற்கால
pirkaalangalil	பிற்காலங்களில்
pirkaalanggalil	பிற்காலங்களில்
pirkaalangkalil	பிற்காலங்களில்
pirgaalaththu	பிராக்கத்து
pirkaalaththu	பிற்காலத்து
pele	கொள்லி
pilae	பிலே
blackberry	பிளேக்டர்
pilaakperri	பிலாப்பேறி
pilaalperri	பிலாப்பெற்றி
plackperry	பிலேக்டர்
pilaanet	பிளாண்டை
pilaant	பிளாண்ட்
plaant	பிளாண்ட்
planet	பிளாண்டட்
plant	பிளாண்ட்
pilai	பிழை
pizhai	பழை
pilaikalai	பிளைகளை
pizhaigalai	பிளைகளை
pilaikal	பிளைகள்
pizhaigal	பிழைகள்
pilaiyaaka	பிளையாக
pizhaiyaaga	பிழையாக
be	டிப்
bea	போ
bee	பேட்
bii	ஜிய்
pee	பே
pii	பியா
beatti	பேட்டி
beatty	பேட்டி
beaty	பேட்டிய
beetty	பட்டி
betty	பட்டி
piiddi	படடி
beatlej	பெட்லாஜ்
beatles	பீட்லர்ஸ்
beatless	பீட்லஸ்
beatlez	பேதெல்
beetles	பீட்லே்
beetless	பீட்லிஸ்
beetlez	பெல்லா்
betles	பெ்்லி
betless	பட்ல்ஸ்க்
betlez	பெ்லால்
biitles	பில்லாஸ்
beepi	பேணி
peepe	பீபே
peepi	பேபி
beeris	பீரிஸ்
peeris	பீரிஸ்
pugalpetrtra	புகல்பெற்ற
pukalpetrtra	புகல்பெற்ற
pukalpettravai	புகல்பர்வதை
pukazhpetra	புகழ்பெற்ற
pukazhpettravai	புகழ்பெற்றவை
pugalpetrtravai	புகல்பர்புறை
pukalpetrtravai	புகல்பர்வேற்றை
pukalpettravai	புகல்பர்வதை
pukazhpetravai	புகழ்பெற்வவை
pukazhpettravai	புகழ்பெற்றவை
pugalpetrtraar	புகழ்பெற்றார்
pukalpetrtraar	புகழ்பெற்றிர்
pukalpettraar	புகழ்பெற்றிரா
pukazhpetraar	புகழ்பெற்றார்
pukazhpettraar	புகழ்பெற்றார்
pugaaril	புராளில்
pukaaril	புகாரில்
pudhusu	புதுசு
puthusu	புதுசு
puduchcheari	புசுசிறேசி
puthuchchaeri	புதுச்சேரி
puthucheri	புதுசீறி
puduchcheariyil	புதுச்சூரியில்
puthuchchaeriyil	புதுச்சூரியில்
puthucheri	புதுசீறி
pudhuchcheariyai	புதுச்சேறியை
puthuchchaeriyai	புதுச்சேறியை
puthucheri	புதுசீறி
pudhumai	புதுமை
puthumai	புதுமை
pudhumaigalai	புதுமைகளை
pudhumaikalai	புதுமைகளை
puthumaigalai	புதுமைகளை
puthumaikalai	புதுமைகளை
pudhumaigal	புதுமைகள்
pudhumaikal	புதுமைகள்
puthumaigal	புதுமைகள்
puthumaikal	புதுமைகள்
pudhuvaiyil	புதுவையில்
puthuvaiyil	புதுவையில்
pudhuvaiyai	புதுவையை
puthuvaiyai	புதுவையை
pudhaiththu	புதைத்து
puthaiththu	புதைத்து
buddharin	புத்தரின்
budhdharin	புத்தரின்
buththarin	புத்தரின்
puththaandup	புத்தாண்டுப்
punidhar	புனிதர்
punithar	புனிதர்
punidhargal	புனிதர்கள்
punitharkal	புனிதர்கள்
punaindhu	புனைந்து
puratchigara	புரட்சிகர்
puratchikara	புரட்சிகர்
purigindrana	புரிகின்றன
puriginrana	புரிகின்றன
purikindrana	புரிகின்றன
puriginaranar	புரிகினரர்
purigindranar	புரிகின்றனர்
purikindranar	புரிகின்றனர்
puridhal	புரிதல்
purithal	புரிதல்
purindhum	புரிந்தும்
purinthum	பிரிந்தும்
purivadhu	புரிவது
purivathu	புரிவது
puraa	போரா
puraakkal	புராக்கள்
puraavin	புராவின்
noayaaga	நோயாக
noayaaka	நோயாக
noyaka	தோயாக
pulambi	புளம்பி
pulampi	புளம்பி
pulampeyarnthu	புலம்பெயர்ந்து
pulavar	புலவர்
pulavargalai	புலவர்களை
pulavarkalai	புலவர்களை
pulavargal	புலவர்கள்
pulavarkal	புரவர்கள்
eerppu	எரப்பு
irppu	இர்பு
puviyeerppu	புவியெப்பு
puviyai	புவியை
poongulali	பூங்குலளி
poonguzhali	பூங்குலளி
puungkulalil	பூங்குலளில்
poochchu	பூச்சு
puuchchu	பூச்சு
poochchugal	பூச்சுகள்
poochchukal	பூச்சுகள்
puuchchugal	பூச்சுகள்
puuchchukal	பூச்சுகள்
bhutan	பூட்டான்
poodaan	போதான்
pootaan	போட்டான்
puudaan	பூடான்
puutaan	பூட்டான்
boaut	போட்
boauut	போர்
boot	கோட்டா
but	பட்ட
puud	பொத்
poonagariyil	பூணகரியில்
poonakariyil	பூணகரியில்
puunagariyil	பூனகிரியில்
puunakariyil	பூணகரியில்
poona	பூண
poonaa	பூணா
puna	புணை
punaa	புனா
pune	புனே
puuna	புணை
puunaa	பூணா
poonai	பூணை
puunai	பூணை
poonaiyin	பூணையின்
becki	பேக்கி
becky	பேக்கி
becqy	பேக்கி
paekki	பேக்கி
peggi	பேகி
peggy	பேக்
pennukkum	பெண்ணுக்கும்
peyaraal	பெயரால்
peyarinai	பெயரினை
peyarin	பெயரின்
peyarilum	பெயரிலும்
peyaro	பெயர்
peyaroa	பெயரோ
peyaroo	பெயரோ
periyadhaaga	பெரியதாக
periyathaaka	பெரியதாக
periyadhaagavum	பெரியதாகவும்
periyathaakavum	பெரியதாகவும்
periyadhu	பெரியது
periyathu	பெரியது
periyadhum	பெளியதும்
periyathum	பெரியதும்
periyar	பெரியார்
periyavaraaga	பெரியவராக
periyavaraaka	பெயியவராக
periyaarin	பெரியாரின்
periyarin	பெரியரின்
periyaarukku	பெரியாருக்கு
periyarukku	பெரியருக்கு
perugiyathu	பெருகியது
perukiyathu	பெருகியது
peruthal	பெருதல்
peruvathargaaga	பெறுவதற்காக
peruvatharkaaga	பெறுவதற்காக
peruvatharkaaka	பெறுவதற்காக
peruvatharkaagavum	பெறுவதற்காவும்
peruvatharkaakavum	பெறுவதற்காவும்
petrtruththanththathu	பெற்றுத்தல்்தடு
pettruththandhadhu	பெற்றுத்தத்து
pettruththanththathu	பெற்றுத்தல்்தடு
baurnami	பெர்னமி
paurnami	பெர்னமி
pournami	புர்ணமி
powrnami	பௌராணிமி
pack	பேஸ்
pacq	பேஸ்
paeek	பேக்
paek	பே
paeq	பே
paik	பைக்
paiq	பைக்
pak	கீ
paq	கீ
peek	பே
pek	கிக்
paechupavarkal	பேசுபவர்கள்
paesubavargal	பேசுபவர்கள்
pesupavarkal	பேசுபவர்கள்
paeththi	பேத்தி
peaththi	பேத்தி
peththi	பேத்தி
bearaasiriyarum	பேராசிரியரும்
paeraasiriyarum	பேராசிரியரும்
pearaasiriyarum	பேராசிரியரும்
baee	பேட
bai	கையீது
baii	கை
bie	பே
biee	பே
bye	பி
byee	பே
byii	கி
paai	பிய
paaii	பேயி
pae	பே
pai	பே
paii	பேயி
pie	பே
piie	பேயே
paigalil	பைகளில்
paikalil	பைகளில்
paigal	பைகள்
paikal	பைகள்
paitan	பைத்தான்
paithon	பத்தான்
paithonn	பத்தான்
paython	பத்தன்
pethonn	போதனன்
pithon	பிதான்
pithonn	பிதான்
python	பிதான்
pythonn	பிதான்
baibil	பெனில்
bible	பில்
paipil	பைபில்
paiyanai	பையனை
paiyin	பையின்
paiyil	பையில்
pongku	பொங்கு
pongu	பொங்கு
pongkum	பொங்கும்
pongum	பொங்கு
pottu	பட்டு
podhumai	பொதுமை
pothumai	பொதுமை
ponnaiyum	பொன்னையும்
poriththu	போரித்து
poruththappattana	பொருத்தப்பட்டன
poruththappattirukkum	பொறுத்தப்பட்டிருக்கும்
porundha	பொருந்த
porundhdha	பொருந்த
poruntha	பொருந்த
porundhavillai	பொருத்தவில்லை
porundhdhavillai	பொருத்தவில்லை
porunthavillai	பொருத்தவில்லை
porulaaga	பொருளாக
porulaaka	பொருளாக
porulaagavum	பொருளாகவும்
porulaakavum	பொருளாகவும்
porulaagaum	பொருளாகும்
porulaakum	பொருளாகும்
poraamai	போராமை
poraamaiyin	போராமையின்
porimurai	பொரிமுறை
poruththadhu	பொருத்தது
poruththathu	பொருத்தது
poruppaettra	பொறுப்பற்ற
poruppeattra	பொறுப்பேற்ற
poruppetra	பொறுப்படற்
porupeattradhu	பொறுபேற்றது
poruppaettrathu	பொறுப்பட்டவு
poruppetrathu	பொறுப்பட்றது
poruppaettru	பொறுப்பட்று
poruppetru	பொறுப்பேற்று
poruppettru	பொறுப்பேற்று
polanaruvai	போலனருவை
poolanaruvai	போலரானுவை
poluthupokkaaka	பொழுதுபோக்காக
poluthupookkaaka	பொழுதுபோக்கா
pozhudhupoakkaaga	பொழுதுபோக்கா
poluthupokku	பொழுதுபோக்கு
poluthupookku	பொழுதுபோக்கு
pozhudupoakku	பொழுதுப்போக்கு
poluthum	பொழுதும்
pozhudhum	பொழுத்து
poaga	போக
poga	போட
poagap	போபா
pogap	போபா்
bhogi	போகே
boagi	போகி
bogei	பொகை
bogey	பேடிய
bogi	போக்
bogie	பொகியே
boogey	புகே
boogie	புகி
poagi	போக
pooki	புகி
poagiraen	போகிறேன்
poagirean	போகிறேன்
poagumboadhu	போகும்போது
poagumpoathu	போகும்போது
poakkuvaraththil	போக்குவரத்தில்
poakkuvaraththai	போக்குவரத்தை
boat	போதட
poat	போத
poatti	போட்டி
poattigalai	போட்டிகளை
poattik	போட்டிக்
poattikkaaga	போட்டிக்காக
poattikkaana	போட்டிக்கான
poattiyaana	போடிடியான
poattiyaanathu	போட்டியானது
poattiyaandahu	போடிட்யந்தா
poatiyaalar	போடியாளர்
poattiyaalar	போடியியாால்
poattiyaalargal	போட்டியாளர்கள்
poattiyaalarkal	போட்டியாளர்கள்
poattiyin	போட்டியின்
poattiyilum	போட்டியிலும்
poattiyil	போட்டியில்
boatil	போடிட்
boattil	போட்டில்
poattil	போட்டில்
poandra	போன்ற
poanra	போர்ன
poantra	போன்ற
poayinar	போயினர்
poyinar	பொனியார்
bauron	போரோன்
bauroon	பரோன்
bauuron	போரோன்
boaraan	போரான்
booraun	புரைன்
booroon	பரூன்
boraun	பரருன்
borauun	பரோனன்
boron	போரன்
poaraan	போரான்
pooran	பூரன்
poarththukkaeyar	போர்த்துக்கரசி்
poarththukkeyar	போர்த்துக்கேய்
porththukkeyar	போர்த்துக்கேய்
portugaeyar	போர்டுகூறிய்
poala	ோறை
pola	போற
poalath	போலத்
polath	போலத்
poalavum	போலவும்
polavum	போலவும்
poalavoa	போலவோ
polavo	போலவோ
bola	போல
bolaa	போல
bolla	போல்லா
boola	போல
boolaa	போல
boolla	போல்லா
bula	போல
poola	போல
poavathu	போவது
povathu	போவது
poavathum	போவதும்
povathum	போவதும்
bro	பொரு
broa	பீரா
fro	போர்
pro	போர்
proa	போர்ட
magadha	கதாத
magatha	மதா
makadha	மதா
makatha	மதா
magalaith	கலைத்து
makalaith	கரைமைத்
makalath	கலமாத்
magaa	கா
magha	மதா
maghaa	மகா
majha	மதா
majhaa	மாா
maka	மக
makaa	கா
magaadaevi	மகாதேவி
magaadevi	மகாதீவி
magaadhaevi	மகாதேவி
magaathaeve	மகாதேவே
mahadevi	மகாதீவி
makaadaevi	மகாதேவி
makaadhaevi	மகாதேவி
makaathaevi	மகாதேவி
mahaaiana	மஹாயண
mahaayana	மஹாயண
mahaiaana	மஹையான
mahaiana	மஹையான
mahaianaa	மஹையான
mahayaana	மஹாயண
mahayana	மஹாயண
mahayanaa	மஹையான
makayan	கையான்
magaalatchumi	மகாலட்சுமி
mahaalaksmi	மஹாலச்சி
mahalatchumi	மலாளத்முமி
makaalatchumi	மகாலட்சுமி
magaaveerar	மகாவீர்
mahaveer	மஹவியர்
mahaveerar	மகவேறர்
makaaveerar	மகாவீர்
magaaveer	மகாவீர்
mahaveer	மஹவியர்
makaaveer	மகாவீர்
magilnthu	மகிழ்ந்து
magizhunthu	மகிழுந்து
makilnthu	மகிழ்ந்து
makizhunthu	மகிழுந்து
magilchchi	மகிழ்ச்சி
magizhchchi	மகிழ்ச்சி
makilchchi	மகிழ்ச்சி
makizhchchi	மகிழ்ச்சி
magilchchiyaaga	மகிய்ச்சியக
makilchchiyaaka	மகில்ச்சியக
makizhchchiyaaka	மகிழ்ச்சியக
magilchchiyaana	மகில்ச்சியான
makilchchiyaana	மகிழ்ச்சியான
makizhchchiyaana	மகிச்சிச்யான
magilchchiyil	மகிழ்ச்சியில்
makilchchiyil	மகிழ்ச்சியில்
makizhchchiyil	மகிழ்ச்சியில்
magilchchiyutan	மகிழிச்சிய்தன்
makilchchiyudan	மகிழ்ச்சிய்துடன்
makizhchchiyudan	மகிழ்ச்சியையுடன்
magilchchiyum	கிளிச்சியும்
makilchchiyum	மகிழ்ச்சியும்
makizhchchiyum	மகிழ்ச்சியும்
mahesan	மஹேசன்
makaechan	மகசைன்
makaesan	மகேசன்
maahees	மேஷி
maahes	மேச்
maahesh	மேஷி
mahees	மேஷ்
maheesh	மகேஷ்
mahes	மேச்
mahesh	மேஷ்
maheshh	மேஷி
makaesh	மகேஷ்
makeesh	மகேஷ்
machuuthikku	மசூதுக்கி
masoothikku	மசூதிக்கு
masuthikku	மசிதுக்கு
masuuthikku	மசூதுக்கி
machuuthiyin	முசுதியின்
masoothiyin	மசூதியின்
masuthiyin	முசுதியின்
masuuthiyin	முசுதியின்
machuuthiyai	முசூதியை
masoothiyai	மசூதியை
masuthiyai	முசுதியை
masuuthiyai	முசுதியை
manjula	மஞ்சுள
manjulaa	மஞ்சுளாள
manamaagaatha	மனமாகத்தா
manamaakaatha	மனமாகத்தா
maninaeramum	மினியரும்
manineramum	மணிநேரமும்
maniyam	மிய்யம்
mandaal	மண்டால்
mandal	மண்டால்
mathippaaga	மதிப்பாக
mathippaaka	மதிப்பாக
mathippeettai	மதிப்பட்டி
madhdhiya	மத்தியா
maththiya	மத்தியா
madhdhiyatharaik	மத்தியதரைக்
maththiyatharaik	மத்தியதரைக்
pirateca	பிரதீபு
piratecam	பிரதேசம்
pirathaesa	பிரதேச
pirathaesam	பிரதேசம்
piratheasa	பிரதேச
pradhaesa	பிரதேச
pradhaesam	பிரதேசம்
mandha	வந்த
mantha	வந்த
mandhamaana	மந்தமான
manthamaana	மந்தமான
mandham	மந்தம்
mantham	மந்தம்
manitharai	மனிதரை
manai	மைனை
manaigal	மனைகள்
manaikal	மனைகள்
manaikku	மனைக்கு
marakkattaigal	மரக்கட்டைகள்
marakkattaikal	மரக்கட்டைகள்
marabinar	மரபினர்
maravallik	மரளவில்
maravallilk	மரளவில்கள்
maruththuvamanai	மருத்துவனைமை
maruththuvamanaigalil	மருத்துவனசாலைச்
maruththuvamanaikalil	மருத்துவனசாலைச்
maruththuvamanaigalum	மருத்துவமானைகளும்
maruththuvamanaikalum	மருத்துவமானைகளும்
maruththuvamanaigal	மருத்துவனமாயக்
maruththuvamanaikal	மருத்துவனமைக்
maruththuvamanaiyai	மருத்துவமையணை
marunthin	மருந்தின்
marunthil	மருந்தில்
marai	மைத்
marainr	மைற்
marinar	மரினர்
mariner	மிரின்
marain	ரரைன்
marine	மாரின்
marukka	மறுக்க
marukkappattu	மறுக்கப்பட்டு
marukkavae	மற்குகவே
vittaargal	விய்து
vittaarkal	வித்தார்கள்
vittarkal	வித்து
matravargalidam	மற்றவர்களையம்
matrtravarkalidam	மற்றவர்களையும்
matrtravarkalitam	மற்றவர்களையும்
mattravarkalidam	மற்றவர்களையும்
matravargalin	மற்றவர்களின்
matrtravargalin	மற்றவர்களின்
matrtravarkalin	மற்றவர்களின்
mattravarkalin	மற்றவர்களின்
matravargalum	மற்றவர்களும்
matrtravargalum	மற்றவர்களும்
matrtravarkalum	மற்றவர்களும்
mattravarkalum	மற்றவர்களும்
matravargalaith	மற்றவர்களைத்
matrtravarkalaith	மற்றவர்களை
mattravarkalaith	மற்றவர்களைத்
matravargalaiyum	மற்றவர்களையும்
matrtravargalaiyum	மற்றவர்களையும்
matrtravarkalaiyum	மற்றவர்களையும்
mattravarkalaiyum	மற்றவர்களையும்
matravargal	மற்றவர்கள்
matrtravargal	மற்றவர்கள்
matrtravarkal	மற்றவர்கள்
mattravarkal	மற்றவர்கள்
malarae	கலரை
malaraiyum	கலையும்
malargalil	மலர்களில்
malarkalil	மலர்களில்
malargalaik	மலர்களைக்
malarkalaik	மலர்களைக்
malargalaith	கலர்்களைத்
malarkalaith	கலர்களைத்
malargalaiyum	மலர்களையும்
malarkalaiyum	மலர்களையும்
malarmaalai	மலர்மாலை
malaiyadivaara	மலையதியாவா
malaiyadivaaraththil	மலையாட்டவிதில்
maadan	ராண்
maatan	மான்
modern	மாடர்ன்
maanikka	மானிக்க
manicka	மின்க்கா
manickka	மினிக்க
maanikkam	மானிக்கம்
manickam	மினிக்
maadhulai	மாதுளை
maathulai	மாதுளை
maara	மாரா
mara	மரா
maraa	மாற
maarbai	மார்பை
maarpai	மார்பை
maaraaga	மாறாக
maaraaka	மாராக
maattramadaiyum	மாற்றமைடையும்
mattramadaiyum	மற்றமைடாவும்
thiranaaligalukkaana	திறனானிகளகளாக
thiranaalikalukkaana	திறனானிகளகளாக
tiranalikalukkana	திறனிலக்களு
maattrup	மாற்றுப்
maatruvathai	மாற்றுவதை
maattruvadhai	மாற்றுவதை
maattruvathai	மாற்றுவதை
maali	மாளி
maalii	மில்லி
mali	மல்லி
malii	மெலிய
maalik	மிளிக்
malik	மளிக்
maliq	மெளிக்
maalai	மைளை
malai	மைளை
maalaigal	மாளைகள்
maalaikal	மாளைகள்
poluthil	பொழுதில்
polutil	பொழுத்தில்
pozguthil	பொகு்ததில்
pozhuthil	பொழுதில்
maalaiyum	மையும்
maalaiyai	மையை
maaligaikku	மலிக்கு
maalikaikku	மலிளைக்கு
maaligaiyilirundhu	மாளியிலைநிரு
maalikaiyilirunthu	மாளியைகிலிருந்து
maaligaiyil	மிழிகைை
maalikaiyil	மாள்கையில்
maasgoavin	மாஸ்கோவின்
maaskoavin	மாஸ்கோவின்
maaskoovin	மாஸ்கீவின்
moscowin	முச்வின்
mikkadhaagavum	மிக்கதாகவும்
mikkathaakavum	மிக்கதாகவும்
mikkadhu	மிக்கத்து
mikkathu	மிக்கத்து
mikkavan	மிக்கவன்
mikkavaraaga	மிகரரவாக
mikkavaraaka	மிகர்வாக
mikkavar	மிக்கவர்
mikkavargal	மிக்கவர்கள்
mikkavarkal	மிக்கவர்கள்
mikkavai	மிக்கவை
mickee	மிக்கி
mickei	மிக்கி
mickey	மிக்கை
micki	மிக்கி
mickii	மிக்கி
mickiy	மிக்கி
micky	மிக்கி
micqee	மிக்கி
micqey	மிக்கை
micqii	மிக்கி
micqiy	மிக்கி
micqy	மிக்கி
mikei	மிக்கி
mikey	மிக்கி
mikii	மிக்லி
mikki	மிக்கி
miqey	மிக்கி
miqii	மிக்லி
miththiran	மித்திரன்
mesion	மிசனன்
mishan	மிஷன்
mision	மியூன்
misionn	மியன்ஸ்ன்
mission	மிசன்
meenavar	மீனவர்
meenavargalukku	மீனார்வளுக்கு
meenavarkalukku	மீனார்களுக்கு
meenvarkalukku	மீன்றங்களுக்கு
pidikka	பிடிக்க
pitikka	பிடிக்க
meengalin	மீன்களின்
meenkalin	மீன்களின்
meengalukku	மீன்களுக்கு
meenkalukku	மீன்களுக்கு
meengalaiyum	மீன்களையும்
meenkalaiyum	மீன்களையும்
meenkalayum	மீன்கலையும்
mugaththuvaaraththil	முகத்துவரத்தில்
mukaththuvaaraththil	முகத்துவரத்தில்
mugaththuvaaram	முகத்துவராம்
mukaththuvaaram	முகத்துவார்
mugamaaga	முகமாக
mugamaaka	முகமாக
mukamaaka	முகமாக
mugamaagavum	முகமாகவும்
mugamaakavum	முகமாகவும்
mukamaakavum	முகமாகவும்
makammathu	மகம்
mohammedhu	முஹம்தீது
mugammathu	முர்மத்து
muhammad	முஹம்்டா
mukammathu	முர்மத்து
mugaitheen	முகைதீன்
muhaideen	முதேயேன்
muhaitheen	முதைதீன்
mukaitheen	முகைதீன்
mukthaa	குத்தா
mukkthi	முக்தி
mukthi	முத்தி
muchuleem	முசுலிம்
musleem	மில்லிம்
muslim	முச்லிம்
musuleem	முசோலியம்
musulim	முசோலிம்
mudindhdhathu	முடிந்தது
mudindthathu	முடிந்தது
mudinthathu	முடிந்தது
mudindhdhathum	குடித்ததும்
mudindthathum	குடித்ததும்
mudinthathum	குடித்ததும்
mudindhdhapoathu	முடிந்தபோது
mudinthapoathu	முடிந்தபோபு
mudindhdhavudan	குடிவதுடன்
mudinthavudan	முடிந்தவுடன்
mudindhdhaalum	குளித்தாலும்
mudinthaalum	முடிந்தாலும்
mudindhdhaal	குடித்தால்
mudinthaal	முடிந்தால்
mudippu	முடிப்பு
mudiyudai	குடியைக்க
mudivirku	முடிவிற்கு
mudivilaa	முடிவில
mudivil	முடிவில்
muthaliya	முதலிய
muthaliyana	முதலியான
muthaliyanavum	முதலியவானும்
muthaliyavargal	முதலியவர்கள்
muthaliyavarkal	முதலியவர்கள்
muthaliyoar	முதலியோர்
muthaliyor	முதலியார்
muththa	வுத்த
muththai	முத்தை
muthaiya	முதையா
muththaiya	முத்தைய
muththaiyaa	முத்தையா
mundhi	முந்தி
munthi	முந்தி
munthik	முந்திக்
munanikku	முனினக்கு
munnanikku	முன்னழிக்கு
munnaniyin	முன்னணியின்
munnaniyai	முன்னழையை
munnuthaaranamaaga	முண்னுதரரமாக
munnuthaaranamaaka	முண்னுதரரமாக
munnedukka	முன்னோட்க்க
munnetukka	முன்னெடுக்க
munmaadhiri	முன்மாதிரி
munmaathiri	முன்மாதிரி
munmadiri	முன்மறிதி
munmaathiriyai	முன்மாதிரியை
munmadiriyai	முன்மதியிலை
munmathiriyai	முன்மதிய்
munvaiththathu	முன்வைத்தது
munvaiththaar	முன்வைத்தார்
munvaiththu	முன்வைத்து
munvaiththullathu	முன்வையுந்தது
mupparimaana	முப்பரிமான
mummuramaaga	மும்முறமாக
mummuramaaha	மும்முராமா
mummuramaaka	மும்முறமாக
muyandranar	முயன்றனர்
muyanranar	முயன்றனர்
muyantranar	முயன்றனர்
muyandrapoathu	முயன்போற்வது
muyanrapoathu	முயன்போது
muyantrapoathu	முயன்போற்வது
muyandraar	முயன்றார்
muyanraar	முயன்றார்
muyantraar	முயன்றார்
muyandraal	முயன்றால்
muyanraal	முயன்றா்
muyantraal	முயன்றால்
muyanrum	முயன்றும்
muyantrum	முயன்று
muraimaigalai	முறைமைகளை
muraimaikalai	முறைமைகளை
muraimaigal	முறைமைகள்
muraimaikal	முறைமைகள்
muraimaikku	முறைமைக்கு
muraimaiyai	முறைமையை
murpattathu	முற்பட்டது
murpattaar	முற்பட்டார்
mulangka	முழங்க
muzhangka	முழங்க
mulavu	முழவு
muzhavu	முழவு
mauhamad	முகமாத்
mauhammad	முஹம்்
mauuhammad	முஹம்மா
mohamad	மோமத்
mohammad	முகம்தா
muhammad	முஹம்்டா
muhammat	முஹம்்
muhammath	முஹம்்தா
muhammed	முஹம்டி
mookku	மூக்கு
mookkuk	முக்கு
mookkum	முக்கு
moondrarai	மூன்றை
moonrarai	மூன்றரை
moondraaga	மூன்றாக
moonraaga	மூன்றாக
moondraavadhum	மூன்றாவதும்
moondraavathum	மூன்றாவதும்
moondrilirundhu	மூன்றிலிருந்து
moondrilirunththu	மூன்றிலிருந்து
moondrilirunthu	மூன்றிலிருந்து
moondrae	மூன்ற
moondre	மூன்ற
moontrae	மூன்ற
moorthi	மூர்த்தி
moorththi	மூர்த்தி
murthi	முர்த்தி
moorthigal	மூர்திகள்
moorththigal	பர்ச்திகள்
moorththikal	மூச்திகள்
murthigal	முர்திகள்
moorthiyaaga	மூத்தியாக
moorththiyaaga	மூச்சியார
murthiyaaga	முத்தியாக
moolakkoorugal	மூலூகூர்கள்
moolakkoorukal	மூலூக்கூர்கள்
moolamoa	மூலம
moolashthaanaththil	மூலச்தாதத்தில்
moolasthaanaththil	மூல்சாந்ததில்
moolgadikkappatta	மூல்கடிக்கப்பட
moolzhgadikkappatta	மூல்கடிக்கப்பட்ட
moozhgadikkappatta	மூல்கடிக்கப்பட
metti	மேடி
maethyoo	மீத்திய
mathew	மதேவே
maeni	மேனி
maeniyai	மீனியை
meniyai	மெனியை
maenilai	மெனிலை
maeman	மேமன்
mamon	மானோ
meman	மேமன்
maembaalap	மேம்பாளப்
maempaalap	மேம்பாளப்
meampaalap	மேம்பாளப்
maembaalam	மேம்பாளம்
maempaalam	மேம்பாளம்
meampaalam	மேம்பாளம்
maelavai	மேளவை
maelavaiyil	மேளவையில்
maelmaruvaththoor	மேல்முறைத்தூர்
melmaruvathur	மேல்முறையவும்
maicroasaapt	மைச்சார்ட்
maicroosooft	மைச்சூர்ட்
maicrosoft	மைச்சொட்டூப்
maicrosopht	மைச்சோபிட்
mecrosoft	மெஸ்கோரிட்
microosooft	மியூச்டர்
microosooftt	மியூச்டர்ட்
microowsooft	மிய்சூசட்டூர்
microsaaft	மிச்சார்ட்
microsoft	மிச்சோடர்
microsoftt	மைச்சொட்டிட்
microsopht	மிச்சோபிட்
microsophtt	மிச்சோட்டூப்
microvsoft	மிக்ச்டரவூட்
microwsoft	மிக்ச்டரவுட்
microwsopht	மிச்சூரிட்
maiyamaaga	மையமாக
maiyamaaka	மையமாக
myyamaaka	மையமாக
maiyamaagak	மையமாகக்
maiyamaakak	மையமாகக்
myyamaakak	மையமாகக்
maiyamaagavum	மையமாகவும்
maiyamaakavum	மையமாகவும்
myyamaakavum	மையமாகவும்
mochchai	மொச்சை
moraaccoa	மோரோச்சா
moraakkao	மோராக்கோ
moraakkoa	மோரோக்கா
morocco	மொரோக்கோடு
moasae	மோசே
mosae	மோச்
yaabbilakkanam	யாப்பினிக்கல்
yaappilakkanam	யாத்பின்களாம்
yaaraavathu	யாவராது
yaaridamum	யாரிடமும்
yaaritamum	யாரிடமும்
yaaridam	யாரிடம்
yaaritam	யாரிடம்
yaaaraenum	யாரெனும்
yaaraenum	யாரெணும்
unesco	மூனேச்சு
yunesco	யுனஸ்கோ
yuneskoa	யூன்ச்கோ
unescovin	உட்வோன்ஸின்
yunescoovin	யுசென்ஸ்வின்
yuneskoavin	யுன்ஸ்கோவின்
iooe	யூர்
iue	யூர்
iuee	யூர்
yooe	யூ
yue	யூர்
yuee	யூர்
yuii	யை
yuu	யூர்
yuue	யூர்
yuuee	யூர்
yooth	யோத்தி
youth	யூத்தி
ioore	யூர்
iuri	ஊரி
uree	ஊரே
urii	ஊரி
uuree	ஊரி
yoore	யூர்
yoori	யூரி
youri	யூரி
yure	யூர்
yuri	யூரி
yuuri	ஊரி
uric	ஊரிச்
yoorik	யூரிக்
yourik	யூரிக்
yellaam	யெல்லாம்
yoagaththin	யோயத்தின்
yoakaththin	யோகத்தின்
yookaththin	யோகத்தின்
yoagan	யோகன்
yoakan	யோகன்
yogan	ரோகன்
yookan	யூகன்
yoagam	யோகம்
yoakam	யோகம்
yogam	யோகம்
yookam	யோகம்
yoakkiyamaana	யோக்கியமான
yokkiyamaana	யூக்கியமான
yookkiyamaana	யூக்கியமான
yoasanaigal	யோசனைகள்
yoasanaikal	யோசனைகள்
yoosanaikal	யோசனியகள்
yoasanaikku	யோசனைக்கு
yoosanaikku	யோசனைக்கு
rasa	ராஜ்
railgal	ரைில்கள்
railhal	ரைல்லா்
railkal	ரைி
raiylgal	ரையில்கள்
raiylhal	ரையில்
raiylkal	ரையில்கள்
rayilgal	ரயில்கள்
rayilkal	ரயில்கள்
rashyan	ரிஷான்
rassian	ரிஷன்
russian	ரிஷன்
ragman	ராம்
rahmaan	ராமான்
rahman	ராமன்
rehhman	ரோமேன்
rehmaan	ரோமான்
rehman	ரோமான்
rehmann	ரோமான்
raajaraajanin	ராஜராஜனின்
rajarajanin	ராஜசராஜின்
raajaraajan	ராஜராஜன்
rajarajan	ராஜசராஜன்
raanuva	ரோனைவ
raanuvath	ராணுவத்
raanuvaththirku	ராணவவத்திற்கு
raanuvaththil	ராணுவத்தில்
raanuvaththai	இராணுவத்தை
raamachchanthiran	ரரமச்சந்திரன்
ramachandran	ராமச்சந்திரன்
ramachchandiran	ராமச்சந்திரன்
ramachchandran	ராமச்சந்திரன்
raam	ராம்
raamaa	ராமா
ram	ரம்
rama	ரமா
raamaayanam	ரராமாயணம்
raamayanam	ரமாயணமயம்
ramayanam	ரமாயணமம்
ring	ரிங்
ringk	ரஞ்சு
rink	ரிங்
rings	ரிங்க்
reserve	ரிசர்வ
risarv	ரிசர்
reeshi	ரீஷி
reesi	ரிசி
reesii	ரிசி
reshii	ரீசி
resii	ரிசாயா
riishi	ரீசி
riisi	ரிசி
riisii	ரிசிரி
rishi	ரிசி
rishii	ரிசி
risi	ரிச்சி
risii	ரிசை
rishigal	ரிஷ்கள்
rishikal	ரிஷ்கள்
reethiyilum	இீதியிலும்
reethiyil	ரீதியில்
roopavaahini	பூபாாிிய
roopavahini	போபாவிி
rupavahini	ருபவனியி
rupavauhini	ருபவேணி
racklaa	ரக்கல்லா
raeklaa	ரேக்காலா
rekla	ரேகலா
raench	ரென்சி
raenjch	ரஞ்சு
radaar	ராடர்
radar	ராதர்
radarr	ரடதர்
raedaar	ரேடார்
redar	ரேடர்
reedar	ரேடர்
raendam	ரேண்டம்
raentam	ரேண்டம்
random	ரொண்டாம்
rendaam	ரேண்டாம்
raaend	ரேந்து
raand	ராண்டா
rand	ராண்டா
reend	ரைந்த
rend	ரைந்து
roadu	ரோடு
roam	ரோம்
rome	ருமே
roavar	ரோவர்
roaver	ரைவர்
roawer	ரைவர்
rooaver	ரூவர்
roovar	ரூவர்
roover	ரூவர்
roower	ரூவ்
rovar	ராவர்
rover	ரைவர்
rowar	ரைவர்
rower	ரைவ்
lachith	சிசித்
lacith	லீசித்ட
lasith	லிசித்
latchanam	லோதனமே
lakchhami	மலச்சாமி
lakshmee	லக்ன்மி
lakshmi	லக்சிமி
laksmee	லக்ஸ்ரி
laksmii	மீக்ரிய்
laqchhami	லக்சாமி
laqsmee	லக்ஸ்ரி
laqsmi	லீக்ரி
lakshimiyin	லக்சியியின்
lakshumiyin	லக்சுமியின்
latchumiyin	லட்சுமியின்
latsumiyin	லூட்சிமியின்
laddu	லேட்டா
lattu	லட்டா
landanil	லன்னடில்
londonil	லந்தோணில்
laththeen	லத்தின்
latiin	லட்டின்
latiina	லேடன்
latin	லத்தின்
lattiin	லட்டின்
letan	லத்தான்
leten	லேடன்
letiin	லெட்டின்
letin	லெட்னின்
lalithaa	லலிதா
laagic	லாகிக்
laajic	லாசிக்
logic	லோகிக்
laabaththai	இலாபத்தை
laapaththai	இலாபத்தை
linda	லின்ட
lindaa	லின்ட
linaks	லினாக்
linux	லுனை
livarpool	ரிய்வார்
livarpuul	ரிய்வொர்டு
liverpool	லிர்பார்
liverpul	லிவில்
liwerpool	லிர்பார்
leaguein	ரேசியன்
leakin	லீகானின்
leakkin	லெய்க்னின்
leekin	லிகன்
loodhana	லோதன
loodhiaanaa	லோதியான
loodhiana	லோதியானா
ludhana	லூதன
ludheeana	லூதியானா
ludheena	லூதியா
ludhiaanaa	லூதியான
ludhiana	லூதியானா
ludhiiana	லூதியான
luudheeana	லூதியான
luudhiana	லூதியானா
luutiyana	லூதியானா
lakshmi	லக்சிமி
letchumi	லட்சுமி
letshumi	லேத்சிமி
laechana	லேசனா
laesaana	இசாசன
laenaa	லேனா
laneaa	லனே
loagiyaa	லோகியா
loakiyaa	லோகியா
vaguththa	வகுத்த
vakuththa	வகுத்த
vaguththadhu	வகுத்தது
vaguththathu	வகுத்தது
vakuththathu	வகுத்தது
vaguththal	வகுத்தல்
vakuththal	வகுத்தல்
vaguththaar	வகுத்தார்
vakuththaar	வகுத்தார்
vaguththaal	வகுத்தால்
vakuththaal	வகுத்தால்
vakkeel	க்க்கீல்
vangadhaesaththin	வங்கடாசத்தின்
vangathaesaththin	வங்ககத்தேசத்தின்
vangkadhaesaththin	வங்ககத்தேஷின்
vangadhaesam	வங்கதாசசம்
vangathaesam	வங்கதேசம்
vangkadhaesam	வங்கதேசம்
vasiththanar	வசித்தனர்
vanchi	வஞ்சி
vanji	வஞ்சி
vansi	வாண்சி
vadanaattil	வடனாட்டில்
vadapuram	வடபுரம்
vadamaerkil	வடமேற்கில்
vatamaerkil	வடமேற்க்
vadikaal	கடிகால்
vadikal	கடிகள்
vadikkappatta	வடிக்கப்பட்ட
vadikkappattathu	வடிக்கப்பட்டது
vattiyai	வட்டியை
vanigarkalin	வணிகர்களின்
vanikarkalin	வணிக்களின்
vanigarkalum	வணிகர்களும்
vanikarkalum	வணிக்களும்
vanigargal	வணிக்கள்
vanigarkal	வணிக்கள்
vanikarkal	வணிக்கற்கள்
vadham	தாவ்
vatham	மத்
wadham	தாவ்
watham	மத்
vandhanar	வந்தனர்
vanthanar	வந்தனர்
vanththanar	வித்தனர்
vanthiyathevan	வந்தியதேவன்
vanthiyaththaevan	வந்தியத்தேனன்
vanthiyaththevan	வந்தியத்தேன்
vanpunarvu	வண்புணர்வு
vamsaththil	வம்சத்தில்
vamsaththai	வம்சத்தை
vayathin	வயதின்
varadhan	ராதன்
varathan	பரதன்
varadham	கரதம்
varatham	கரதம்
varappoagum	வரப்போகும்
varappoakum	வரப்போகும்
varalaam	கரைம்
varalaattruch	வரளாற்றுச்
varalaattruth	வரளாற்றுத்
varavaal	வரவால்
varavirukkum	வரவிருக்கும்
varaaga	வராக
varaaka	வராக
varaga	கரவ
vari	ஊழி
varigalai	வரிகளை
varikalai	வரிகளை
varigal	கரிகள்
varikal	கரித்
variyil	வரியில்
variyai	வரியை
varudi	வருடி
varuvaai	வருவாய்
varuvaay	வருவாய்
varuvaaith	வருவாதி
varuvaayth	வருவாதி
varuvaith	வருவைத்
vruvaayth	விவாயத்து
varaikooda	வரைகூட
varaikoodaa	வரைகோடா
valasai	வளைசை
valimaiyaana	வலிமையான
vallarasu	வல்லரசு
valaththaiyum	வலத்தையும்
valaigutaa	வலைக்குட
valaikudaa	வலைகுகாட
valaikutaa	வலைக்குட்ட
valaigutaavil	வலையுக்காவதில்
valaikudaavil	வலைகுடுவாசில்
valaikutaavil	வலையுக்காடில்
valakku	வழக்கு
vazhakku	வழக்கு
vicarikka	விகாரிக்க
visaarikka	விசாரிக்க
visarikka	விசரிக்க
valakkugalil	வழக்குகளில்
valakkukalil	வழக்குகளில்
vazhakkukalil	வழக்குகளில்
valakkugalukku	வலக்குகளுக்கு
valakkukalukku	வலக்குகளுக்கு
vazhakkukalukku	வழக்குகளுக்கு
valakkugalum	வழக்குகளும்
valakkukalum	வலக்குகளும்
vazhakkukalum	வழக்குகளும்
valakkugalaiyum	வழக்குகளையும்
valakkukalaiyum	வழக்குகளையும்
vazhakkukalaiyum	வழக்குகளையும்
valakkup	வழக்குப்
vazhakkup	வழக்குப்
valakkurai	வலக்குறை
vazhakkurai	வழக்குறை
valangappadaamal	வழங்கப்படாமல்
vazhangappadaamal	வழங்கப்படாமல்
vazhanggappadaamal	வழங்கப்படலாம்
valangappaduvathu	வழங்கப்படுவது
valangkappaduvathu	வழங்கப்படுவது
vazhanggappaduvathu	வழங்கப்படுவது
vazhangkappaduvathu	வழங்கப்படுவது
valangal	வளங்கள்
valangkal	வளங்கள்
vazhangkal	வழங்கல்
valangkunar	வழங்குணர்
valankunar	வழங்குநர்
vazhanggunar	வழங்குணர்
vazhangkunar	வழங்குணர்
vazhankunar	வழங்குணர்
valangkuvathutan	வழங்குவதனைன்
valanguvathudan	வழங்குவதுடன்
vazhangkuvathudan	வழங்குவதுவன்
vazhanguvathudan	வழங்குவதுடன்
valangkuvathai	வழங்குவதை
valanguvathai	வழங்குவதை
vazhangkuvathai	வழங்குவதை
vazhanguvathai	வழங்குவதை
valigaattu	வழிகாட்டு
valikaattu	வழிகாட்டு
vazhigaattu	வழிகாட்டு
vazhikaattu	வழிகாட்டு
valikaattum	வழிகாட்டும்
vazhigaattum	வழிகாட்டும்
vazhikaattum	வழிகாட்டும்
valiththoanral	வலித்தொன்றள்
vazhiththoantral	வழித்தொடர்ல்
valiththoanralkal	வலித்தொன்கள்கள்
vazhithoantralgal	வழிதேற்றங்கள்
vazhiththoantralgal	வழித்தொடங்களில்
valinadaththi	வளியநாத்தி
vazhinadaththi	வழியநடத்தி
valinadaththinaar	வளியந்தடினார்
vazhinadaththinaar	வழிநாடத்தினர்
valinadaththum	வலிந்ததும்
vazhinadaththum	வழிநாடத்தும்
valukku	வழுக்கு
vazhukku	வழுக்கு
vavuniya	வுனியா
vavuniyaa	வுுவியா
vaagananggalin	வாக்கங்களின்
vaaganangkalin	வாக்கங்களின்
vaakanangkalin	வாக்கங்களின்
vaagananggalukku	வாகனங்களுக்கு
vaaganangkalukku	வாகனங்களுக்கு
vaakanangkalukku	வாகனங்களுக்கு
vaaganagkalaik	வாகனங்களைக்
vaagananggalaik	வாகனங்களைக்
vaakanangkalaik	வாகனங்களைச்
vaagananggalaiyum	வாகனங்களையும்
vaaganangkalaiyum	வாகனங்களையும்
vaakanangkalaiyum	வாகனங்களையும்
vaaganaththai	வாகத்தை
vaakanaththai	வாகத்தை
vaaganamaaga	வாகமணிக
vaaganamaga	வாகமணிக
vaaganamaka	வாகமணிக
vaakanamaaka	வாகணமாக
vaakanamaga	வாகணமாக
vaakanamaka	வாகணமாக
vaaganam	வாகனம்
vaakanam	காவனம்
paesalaam	பேசலாம்
pecalam	பேசல்
pesalaam	பேசலாம்
vaangappadum	வாங்கப்படும்
vaanggappadum	வாங்கப்படும்
vaangkappadum	வாங்கப்படும்
vaangappattu	வாங்கப்பட்டு
vaanggappattu	வாங்கப்பட்டு
vaangkappattu	வாங்கப்பட்டு
vaangavum	பான்கவும்
vaanggavum	பழ்வகும்
vaangguthal	வாங்குதல்
vaangkuthal	வாங்குதல்
boadhum	போதும்
poadhum	போதும்
poathum	போதும்
vaanggum	பங்கும்
vaangkum	வங்கும்
vaangum	கங்கும்
vaasippathil	வாசிப்பதில்
vaasippathu	வாசிப்பது
vaasippavar	வாசிப்பவர்
vaadiya	வாடிய
vaater	வீட்டர்
vatar	வரத்
vater	வேதர்
vaterr	வேடர்
veter	வீட்டர்
vouter	வூட்டர்
waatar	வாத்
waater	வீட்டர்
waeter	வேடர்
watar	வரத்
watarr	வரத்
water	வேதர்
waterr	வேடர்
weter	வீட்டர்
weterr	வீட்டர்
woutar	வோட்டார்
wouter	வூட்டர்
wouuter	வூட்டர்
vaattara	வாற்ற
vaatters	வாட்டர்ஸ்
waters	வேட்டர்
vaathittathu	வாதிதத்து
vaathittaar	வாதிட்டார்
vaathittu	வாதிட்டு
vaayilaagavum	வாயிலாகவும்
vaayilaakavum	வாயிலாகவும்
vaalin	வளின்
vaazhvathu	வாழ்வது
vaalvar	வாழ்வர்
vaazhvar	வாழ்வர்
vaazhvilirundthu	வாழ்விலிருந்து
vaazhvilirunththu	வாழ்விலிருந்து
vaazhvilirunthu	வாழ்விலிருந்து
vaalvu	வள்வு
vaazhvu	வள்வு
vaalvum	வள்வும்
vaazhvae	வாழ்வ
vaazhvum	வர்வும்
vaasthu	வாஸ்து
vigaaraigal	விகாரைகள்
viharaigal	விகரைகள்
vikaaraigal	விகாரைகள்
vikiraman	விகிரமணி
vikkiraman	விக்கிரமணன்
vikraman	விக்ரமன்
vichaariththa	விசாரித்த
visaariththa	விசாரித்த
vichaeshamaana	விசேசமான
visaeshamaana	விசேமணா
vichai	விசை
visai	விசை
vichaikalai	விசைகளை
visaigalai	விசைகளை
visaikalai	விசைகளை
visaiyin	விசையின்
visaiyudan	விசுடையன்
vinchi	தின்சி
vinjchi	வின்சி
vinchiya	விஞ்சிய
vinjchiya	விஞ்சிய
vidayanggalai	விடையங்களை
vidayangkalai	விடையங்களை
vitayangkalai	விதய்
vidayaththai	விடைத்தை
vitayaththai	வியத்தை
vidayamaaka	விடையமாக
vidayanmaaga	விடட்யமாக
vitayamaaga	வியட்டாக
vidayam	விடயம்
vitayam	வியடடம்
vittaal	கிட்டா்
vittaen	வைத்திக்
vidhikka	விதிக்க
vithikka	விதிக்க
vithikkavillai	விதிக்கலவில்லை
vidhdhiyaa	வித்தியா
vidhya	வித்யா
viththiyaa	வித்தியா
viththiyaachaththil	வித்தியாசத்தில்
viththiyaasaththil	வித்தியாசத்தில்
viththiyaachaththai	வித்தியட்சத்தை
viththiyaasaththai	வித்தியாசத்தை
viththiyaachap	வித்தியாசப்
viththiyaasap	வித்தியசாச்
viththiyaaamaaga	வித்தியமாக
viththiyaachamaaka	வித்தியாசமாக
viththiyaasamaaga	வித்தியாசமாக
viththiyaasam	வித்தியாசம்
vineedh	விநித
vineeth	விநெத்த
vibaththin	விதத்தின்
vipaththin	விபத்தின்
vibaththil	விபத்தில்
vipaththil	விபத்தில்
vimarsiththaar	விமர்ச்திராட்
vimarsiththullaar	விமர்ச்திடுள்ளார்
vimaanangalin	விமானங்களின்
vimaananggalin	விமானங்களின்
vimaanangalum	விமானங்களும்
vimaananggalum	விமானங்களும்
vimaananggal	விமானங்கள்
vimaanankal	விமானங்கள்
viyantha	வியந்த
viyanththa	வியந்த
viyanththu	வியந்து
viyanthu	வியந்து
viyaabaarigalin	வியாபிராகில்
viyaapaarigalin	வியாதிராகிின்
viratha	வரரத
virathangal	விரதங்கள்
virathanggal	விரதங்கள்
virathangkal	விரதங்கள்
viradham	கிரதம்
viratham	விரதம்
virivaaga	விரிவாக
virivaagath	விரிவாகத்தா
virivuraigal	விரிவுரைகள்
virumbaatha	விரும்பாத
virumbaathu	விரும்பாது
virpathu	விற்பது
vitrtrathu	விற்றது
vittradhu	விற்றது
vittrathu	விற்றது
vitrtral	விற்றல்
vittral	விற்றல்
vitrtraar	விற்றார்
vittraar	விற்றார்
viliam	விலியம்
viliiam	விலியம்
viliyam	விலியம்
villiam	வில்லியம்
villiyam	வில்லியம்
wiliam	விலியம்
wiliiam	விலியம்
wiliyam	விலியம்
william	வில்லியம்
villiams	வில்லாம்
villiyams	வில்லியம்
wiliams	ிில்வாக்
williams	வில்லாம்
villaigal	வில்லக்
villaikal	கிள்வைகள்
villaiyum	விலையும்
vilaadimir	விலாடினிர்
viladimir	விலடிமிர்
vlaadimir	விளாதினிர்
vlademar	விளேயம்
vlademer	விளைடீர்
vladimir	விளாடிமர்
vladimirr	விளாடினிர்
vladymyr	விளாட்டிர்
wlademer	லைவடர்
wladimir	லாவினிரம்
wladimirr	லாவலிமிரம்
wladymyr	விளாட்டிர்
vilimbugal	விமைப்புகள்
vilimbukal	விமைப்புகள்
vilimpugal	விமைப்புகள்
vilimpukal	விமைப்புகள்
vilaiyaada	விளையாட
vilaiyaadappadum	விளையாடப்படும்
vilaiyaadavillai	விளையாடவில்லை
vilaiyaadudhal	விளையாடுதல்
vilaiyaaduthal	விளையாடுதல்
vilaiyaattaagavum	விளையாட்டவரகும்
vilaiyaattaakavum	விளையாட்டவரும்
villupuram	தில்லுப்பம்
viluppuram	சிழுப்புறம்
vilupuram	விலுப்பர்
vizhuppuram	விழுப்புறம்
vivariththaar	விவரித்தார்
vivariththullaar	விவரித்துள்ளார்
vishaagaa	விஷாக
vishaakaa	விஷாக
vishaka	விஷாக
veesappatta	வேசப்பட்ட
veechith	வீசித்
veesith	வீசித்த
veechina	வீசினா
veesina	வீசினா
veechuthal	வீசுதல்
veesuthal	விசுதல்
veechuvatharku	வீசுவதற்கு
veesuvatharku	விசுவதற்கு
veetirkuch	வீட்டிற்கு
veettirguch	வீட்டிருக்க்
veettirkuch	வீட்டிற்குக்
veettilae	வீட்டிலே
veeraraaga	வீரராக
veeraraaka	வீரராக
veetrirukkum	வீற்றிருக்கும்
veetrtrirukkum	வீற்றிருக்கும்
veettrirukkum	வீற்றிருக்கும்
veel	க்
veil	கெயில்
viil	கிள்
weiil	கெய்
weil	ரெல்
wheel	க்ல்
veelchchikkum	மீள்ச்சிற்கும்
veerzhchchikkum	வீர்ச்சிக்கும்
veezhchchikkum	மீழ்ச்சிக்கும்
veelchchiyin	வீழ்ச்சியின்
veezhchchiyin	வீழ்ச்சியின்
veelchchiyilirunththu	வீழ்சியிலிலிருந்து
veezhchchiyilirunththu	வீழ்சியிலிலிருந்து
veezhchchiyilirunthu	வீழ்சியிலிருந்து
veelchchiyum	கீழ்ச்சியும்
veezhchchiyum	கீழ்விச்சும்
veelnththathu	வீழ்ந்தது
veezhnthathu	வீழ்ந்தது
vedikkach	வெடிக்கச்
veppaththin	வெப்பத்தின்
veppaththaith	வெப்பத்தை
veppaththaiyum	வெப்பதையும்
veppap	வீப்பா்
veppamaaga	வெப்பமாக
veppamaaka	வெப்பமாக
veruththa	வெருத்த
veruththaar	விருத்தார்
verumai	வெருமை
verumaiyaaga	வெருமையாக
verumaiyaaka	வெறுமையாக
vetrikaramaaka	வெற்றிகரமாக
vetrtrigaramaaga	வெற்றிகரமாக
vetrtrikaramaaka	வெற்றிகரமாக
vetrida	வெற்றிட
vetrtrida	வெற்றிட
vetrtrita	வெற்றிட
vettrida	வெற்றிட
vetridaththil	வெற்றிடத்தில்
vetrtridaththil	வெற்றிடத்தில்
vetrtritaththil	வெற்றியத்தில்
vettridaththil	வெற்றிடத்தில்
vetrtridaththai	வெற்றிடத்தை
vetrtritaththai	வெற்றிதட்டை
vettridaththai	வெற்றிடத்தை
vetrtridam	வெற்றிடம்
vetrtritam	வெற்றிடம்
vettridam	வெற்றிடம்
vaelsh	வேல்ச்
vels	களவே
velsh	வேல்ச்
veyls	கொள்ள்
weils	டெல்
wells	ளள்
wellsh	வள்ள்
wels	களவே
welsh	வேல்ச்
weyls	டெல்
weylsh	வில்ச
velip	வெளிப்
velippadaiyaanadhu	வெளிப்படையானது
velippadaiyaanathu	வெளிப்படையானது
velippuram	வெளிப்புறம்
veliyidappattana	வெளியிடப்பட்டன
vaegam	வேகம்
vaekam	வீகம்
vaedhak	வேதக்
vaethak	வததக்
vedeec	டீடிக்
vedic	வீடிக்
vediic	வீடிக்
vedik	டெடிக்
vediq	டெடிக்
veedeec	டீடி
veedic	வீடிக்
veedik	கீடிக்
veetak	கீடாக்
wedeec	டீடிக்
wedic	வீடிக்
wedik	டெவிக்
vaedhangkalil	வேதங்களில்
vaethangalil	வேதங்களில்
vaethangkalil	வேதங்களில்
vaedhaththin	வேதத்தின்
vaethaththin	வேதத்தின்
vaedhaththil	வேதத்தில்
vaethaththil	வேதத்தில்
vaedhaththai	வேதத்தை
vaethaththai	வேதத்தை
vaedhaalam	வேதாளம்
vaethaalam	வேதாளம்
vedhaalam	வேதாளம்
vaedhi	கேதி
vaethi	வேதி
vedhi	தே
vaedhipporulkal	வேதிப்பொருள்கள்
vaethipporutkal	வேதிப்பொறுகிறா்
vaedhiyar	வேதியர்
vaethiyar	வேதியர்
vaenae	வேணன்
vanae	வனே
vae	கீ
vaei	கை
vaey	கை
vai	கள்
vay	கத்தின்
veey	கிய
wae	விய
waee	கோவே
wai	கை
way	கையே
vaerudan	வேருடன்
vaerutan	வேருடன்
vaerldu	வேர்லுட்
world	வர்டட்
vaeraaga	வேராக
vaeraaka	வேராக
vaeroru	கேருவு
vaeroruvan	வேருவர்
vaeroruvar	வேறுவர்
vaelunaachchiyaar	வேலுநான்சியார்
velunachiyar	வெளுநாய்சி்
vaelai	களவை
vaelaigalin	வேலைகளின்
vaelaikalin	வேலைகளின்
vaelaigalum	வேளைகளும்
vaelaikalum	வேளைகளும்
vaelaigalai	வேலைகளை
vaelaikalai	வேலைகளை
vaelaik	வேலைக்
vaelaikkaana	வேலைக்கான
vaelaikkup	வேலைக்குப்
vaelaikkum	வேளைக்கும்
vaelaich	வேலைச்
paarppavar	பார்ப்பவர்
paarththu	பரர்து
parppavar	பர்ப்பவர்
vaelaiyaaga	வேலையாக
vaelaiyaaka	வேலையாக
vealaiyaaka	வேலையாக
vaelaiyin	வேளையின்
vealaiyin	வேளையின்
vaelaiyil	வேளையில்
vealaiyil	காலையில்
vaelaiyaiyum	வேளையையும்
vealaiyaiyum	வேலையையும்
vai	கள்
vaiguntarin	வைக்கொண்டிரு
vaikundarin	வைக்குணர்டின்
vaiguntar	வைக்குண்டார்
vaikundar	வைக்குண்டார்
vaiththiyanaatha	வைத்தியநாத
vaiththiyanaathan	வைத்தியநாதன்
vaibavam	விபவம்
vaipavam	விபவம்
volga	கொள்க
volgaa	கொள்க
voolga	கூள்க
voolka	கூள்க
vooulga	கூள்க
voulga	கூள்க
vouulga	கூள்க
wolga	கொள்க
wolgaa	கொள்களை
woolga	கூள்க
woolgaa	கூழ்க
woulga	கூள்க
shaam	மான்
sham	மான
shaavai	சாவை
shahvai	சாவை
shavai	சாவை
escotch	ஈஸ்ட்கோ
scotch	ஸ்கோட்
skaatch	ஸ்காட்சி
skoch	ஸ்கோச்
skotch	ஸ்கோட்ச்
sqoch	ஸ்கோச்
sqotch	ஸ்கோட்ச்
scotlaanththin	ஸ்கோல்லாந்தின்
scotlandin	ஸ்கொட்லாந்தின்
skaatlaandhin	ஸ்கொல்லாந்தின்
sthaabaga	ஸ்டாபன
sthaapaga	ஸ்டாப
shreenivaachan	ஸ்ரீநிதாஜன்
sreenivaasan	ஸ்ரீனிவாசன்
srinivaachan	ஸ்ரீனிவாசன்
srinivaasan	ஸ்ரினிஷாவன்
srinivasan	ஸ்ரீனிவாசன்
shreerangkaththil	ஸ்ரீதங்கத்தில்
sreerankaththil	ஸ்ரீராந்தித்தில்
srirangaththil	ஸிரிந்தபத்தில்
sriranggaththil	ஸிரிந்கத்தில்
srirangkaththil	ஸிரெந்தியத்தில்
hangaran	ஹங்கரர்
hangarian	ஹங்கரியன்
hankeeriyan	ஹங்கேரியன்
hungaran	உுங்கரன்
hungarian	உங்கதரியன்
huungarian	ஹுங்கரியன்
hanggaeriyil	ஹங்கேற்கிலில்
hankeariyil	ஹங்கேரியில்
hungaeriyil	ஹுங்காரிலில்
hungaryil	ஹுங்கரூலில்
hungaryyil	ஹுங்கரூயில்
harijan	ஹரிஜன்
paattar	பாட்டர்
paatter	பட்டேர்
pattar	பட்டார்
potter	பட்டேர்
haaris	தரஸி
hairis	ஹெரிஸ்
hairiss	ஹெடிஸ்ஸ்
hares	ரேஸ்
haris	திரிஸ்
hariz	தரில்
harres	ராஸ்
harrij	ஹரிரி
harris	ஹிரிஸ்
harriss	ஹிரிஸ்
harriz	ஹரில்
heriss	ஹெரிஸ்
hael	ஹியா
hel	ஹெல்
hell	தெல்
haidroa	ஹைடோரோ
haitrao	ஹைட்ரா
hydro	தயற்ோ
haithar	தைதார்
hyder	தையர்
