faarm	பார்ம்ம்ம்
farm	பொர்ம்்
form	போர்ம்ம்ம்ம்ம்ம்ம்ம்ம்ம்ம்ம்ம்ம்
hpaarm	்பார்ம்
face	பாகேச்
hpaes	ைப்பேக்்
pace	பச்சே
paes	ஃபேசேப்பேப்பேப்ப
phase	பசசப்பப்
aeathimuka	எதிமுக்க
aiathimuka	அததிமுக்க
ayiathimuka	அய்யதிமுக்க
agaththi	காதத்தி
akaththi	காத்தி
agaththikkeerai	அகத்திக்கீரை
akaththikkeerai	காதத்திக்கிறை
agamadhabaath	அகமமபதததாததாததாத்
agamathaabaath	அகமதாபாதாத்
ahamadabad	அமமடபாபடபடபடபடபடபடபடபடபடபடபடபடபட
ahemadaabad	அமேமடபபாகதகபாடப்
ahmadabad	அம்படபபாபடபடபடபடபடபடபடபடபடபடபடபட
ahmedabad	அஹமதபாபடபடபடபடபடத
akamatapat	அகமதபடபடபடபட்டப்பட்டப்பட்டபட்டப்
agamadhabaatthil	அகமபதபாத்தில்
agamathaabaaththil	அகமதபாப்த்தில்
ahmadabadil	அஹ்படபாபடிில்
ahmedabadil	அஹமாபடபடிில்
ahmedabadthil	அம்மதபாப்பட்்
agazhaaivil	அகழாய்வில்
agazhaayvil	அகழாய்வில்
akalvaaivil	அகல்வாய்வில்
akazhaayvil	அகழாய்வில்
akazhvaaivil	அகழ்வாய்வில்
ahimsai	அதிம்பைசை
akimsai	கேகிம்சை
angkeegariththu	அங்கீகரித்து
angkeekariththu	அங்கீகரித்து
angkeegariththullathu	அங்கீகரித்துள்ளது
angkeekariththullathu	அங்கீகரித்துள்ளது
angkeegaarangkal	அங்கீகாரங்கள்
angkeekaarangkal	அங்கீகாரங்கள்
angkeegaaraththaip	அங்கீகாரத்தைப்
angkeekaaraththaip	அங்கீகாரத்தைப்
asaiyaa	அசையாா
ashokan	சசோகன்
asokan	அசோகன்
achoakaa	அச்சோகா
ashok	அசோகோகோகோகோகோகோசோகோஸோகோகோகோசோகோஸ
ashoka	ஆஷோகோகோகோகோக்கோகப்கோகப்
ashokaa	அசோகோா
asok	ஆசோக்கஸ்கூக்கோச்சாக்ஸ்கூக்கோக்கா
asoka	ஆசோகோகோகப்கோக
asokaa	அசோகா
asook	சசூக்கோக்கோக்கோக்
asooka	அசோகோகோ
asookaa	அசோகாகா
asoq	அசோக்காசோசோக்
asoqa	ஆசோகோக்கோகாக்கோக்கோக்
asoqaa	அசோகாகா
adakki	அடக்கி
adakkik	அடக்கிக்கிக்
adainkiya	அடைக்கிய
adangiya	அடங்கியை
adankiya	அடங்கியை
adanggiyadhu	அடங்கியது
adanggiyathu	அடங்கியது
adangiyadhu	அடங்கியது
adangiyathu	அடங்கியது
adankiyathu	அடங்கியது
adangiyulla	அடங்கியுள்ள
adangkiyulla	அடங்கியுள்ள
adankiyuzhzha	அடங்கியுள்ள
pidiththu	பிடித்து
pitittu	படைக்திட்டு
aada	ஆதா
aadaa	ஆதாரா
ada	தாடா
adaa	தடாவா
manadhil	மனாததில்
manathil	மனதில்
manatil	மனாட்டில்
adigalum	அடிகளும்
adihalum	அடிகளும்
adikalum	அடிகளும்
adigalaiyum	அடிகளையும்
adigalayum	அடிகளையும்
adikalaiyum	அடிகளையும்
adikalayum	அடிகளையும்
adikkadi	அடிக்கடிடி
adikkadik	அடிக்கடிக்களிக்
adikku	அடிக்கு
adith	அடித்தித்தி
adiyilirundhu	அடியிலிருந்து
adiyilirunthu	அடியிலிருந்து
adiyilum	அடியிலும்
adiyum	கடியும்
atiyum	அடியும்
adiyai	அடியை
atiyai	அடியை
aduththum	அடுத்தும்
aduthum	அடுத்தும்
adutthum	அடுத்தும்
adaithal	அடைத்தல்ல்
ataithal	அடைத்தல்ல்
attooliyangalum	அட்டோலியங்களும்
attoozhiyangalum	அட்டோழியங்களும்
attoozhiyanggalum	அட்டோழியங்களும்
andar	அண்டார்
antar	அண்டார்
under	ந்திர்
annan	ஞன்னனனனனனனனனனனனனனனனனனனனனனனனனனனனன
adhanadhan	அதனதனதன்
adhanathan	அதனதனதனன்
athanathan	அதனதனதனன்தன்
adhanudan	அதனுடன்
athanudan	அதனுடன்
adhaavadhu	அதாவது
adhavadhu	அதவது
athaavathu	அதாவது
athavathu	அதவது
adhigappadiyaaga	அதிகப்படியாக
athigappadiyaaga	அதிகப்படியாக
athikappatiyaaka	அதிகப்படியாக
adhikamaanathu	அதிகமானது
athigamaanathu	அதிகமானது
athikamaanathu	அதிகமானது
adhidhi	அதிதி
adiiti	அதிதிடிடிடிடிடிடிடிடிடிடிடிடிடிட
adiitii	அடிட்டி
adiittii	அடிட்டி
aditi	அடிட்டிடிடிடி
aditii	அடிட்டி
aditti	அடிட்டி
athithi	அதிதி
atiti	அதிதிடிடிடிடி
adhiradi	அதிரடிடி
athiradi	அதிரடி
adhirvu	அதிர்வு
athirvu	அதிர்வு
adhirvukaly	அதிர்வுகளில்
athirvukalai	அதிர்வுகளை
athirvukalay	அதிர்வுகளையே
athirvugal	அதிர்வுகள்
athirvukal	அதிர்வுகள்
adhilum	அதிலும்
athillum	அதில்லும்
athilum	அதிலும்
adhilaeyae	அதிலேயேயே
adhileye	அதிலேயேயே
athilaeyae	அதிலேயேயே
athileye	அதிலெயேயே
adheedhamaana	அதேதமானான
adhidhamana	அதிதமானனன
atheethamaana	அதேதமானான
athithamana	அதித்தமணன
adhaepoal	அதேபோல்
ateepool	அதேப்போலோல்
atepol	அதப்போலோல்லூல்
athaepool	லதேபூலோல்
aththiyaayangalil	அத்தியாயங்களில்
aththiyaayangkalil	அத்தியாயங்களில்
aththiyaayangalai	அத்தியாயங்களை
aththiyaayangkalai	அத்தியாயங்களை
aththiyaayangal	அத்தியாயங்கள்
aththiyaayangkal	அத்தியாயங்கள்
aththiyaayaththin	அத்தியாதத்தின்
aththiyaayaththil	அத்தியாதத்தில்
aththiyaayam	அத்தியாயம்
andhak	அந்தக்கக்கக்கக்
andhakh	அந்தகதக்கக்
anthak	அந்தகக்கக்
andhandha	ஆந்தந்தந்த
anthantha	ஆந்தந்த
andhoni	நந்தோணி
anthoni	நந்தோணி
anthony	அந்தொனியி
antony	நா்தோணி
ananrtham	அனந்தம்
anarththam	அனர்த்தம்
aneeta	ஆநீததாத
aneetaa	அணேதாடாட்டாட்டாட்டாட்டாட்டா
aniita	ஆணிட்டாட
aniitaa	ஹனிதா
anita	ஆணிட
anitaa	அணிதாதாடாடாடாதா
anitha	அணித்ததை
anithaa	அணிதாதா
anubama	அனுபமாமம்
anubamaa	ஆனுபமாமா
anupama	அனுபமாம்
anupamaa	அனுபமாமாமா
anubavika	அனுபவிக்காக
anubavikka	அனுபவிக்கக்க
anupavikka	அனுபவிக்க்க்க
anuppia	அனுப்பிய
anuppiya	அனுப்பியைய்
anuppiyathu	அனுப்பியது
anuraadhapuraththil	அனுராதபுரத்தில்
anuraathapuraththil	அனுராதபுரத்தில்
anuradhapuraththil	அனுரதுபாதுததத்தில்
anurathapuraththil	அனுரதபபுரத்தில்
anuraathapuram	அனுராதபுரம்
anuradhapuram	அனுராபுரம்
anurathapuram	அனுரதபுரம்
anniya	கன்னிய
anbai	அன்பை
anbaip	ன்பைப்
anpaip	அன்பைப்
anbaiyum	அன்பையும்
andri	த்தி
antri	தன்றி
andriravu	அன்றிரவு
antriravu	அன்றிரவுவவு
abinaya	அபினையாயை
apinaya	அபினாயையையா
abudhabiyil	அபுதபியில்
abuthaabiyil	அபுதாபியில்
abul	லாலுவால்லால்லால்லால்லால்லால்லால்
aboorvamaana	அபூர்வமான
aburvamaana	அபுர்வமான
apoorvamaana	அபோர்வமான
appagudhi	அப்பகுதி
appaguthi	அப்பகுதி
appakuthi	அப்பகுதி
appaguthigalil	அப்பகுதிகளில்
appaguthikalil	அப்பகுதிகளில்
appakuthikalil	அப்பகுதிகளில்
appaguthikku	அப்பகுதிக்கு
appakuthikku	அப்பகுதிக்கு
appaguthiyin	அப்பகுதியின்
appakuthiin	அப்பகுதிநின்
appakuthiyin	அப்பகுதியின்
appadaththil	அப்படத்தில்
appadatthil	அப்படத்தில்
appadaththai	அப்படத்தை
appadatthai	அப்படத்தை
appadiyaanaal	அப்படியானால்
appaadal	அப்பாடல்
appaatal	அப்பாடலடல்
apengal	அபேங்கள்
apenkal	அபேங்கள்
appenkal	அப்பெண்கள்
appoluthu	அப்பொழுத்து
appozhudhu	அப்போழுது
appozhuthu	அப்போழுத்து
americar	அமெரிகர்கர்
amerikkar	அமெரிக்கர்
amerikkargalukku	அமெரிக்கர்களுக்கு
amerikkarkalukku	அமெரிக்கர்களுக்கு
amerikkargal	அமெரிக்கர்கள்
amerikkarkal	அமெரிக்கர்கள்
amaerikka	அமேரிக்க
amarica	அமரிச்சரச்
amaricaa	அமரிசாக
amarika	அமரிக்க
amarikaa	அமரிகாகா
america	அமெரிக்க்க்க
americaa	அமெரிகா
amerika	அமெரிகாக
amerikaa	அமெரிகாகா
amerikka	அமெரிக்க
ameriqa	அமெரிகா
ameriqaa	அமெரிகா
americaavirku	அமெரிக்காவிர்க்
americavirkku	அமெரிக்கவிற்கு
americavirku	அமெரிக்கவிற்கு
amerikkaavirku	அமெரிக்காவிற்கு
americaavil	அமெரிக்காவில்
americavil	அமெரிக்காவில்
amerikkaavil	அமெரிக்காவில்
americaavukku	அமெரிக்காவுக்கு
americavukku	அமெரிக்கவுக்கு
amerikkaavukku	அமெரிக்காவுக்கு
americaavai	அமெரிக்காவை
americavai	அமெரிக்காவை
amerikkaavai	அமெரிக்காவை
amaichchup	அமைச்சுப்புப்
amaiththu	வமைத்து
amaithu	அமைத்து
amaitthu	அமைத்து
amaiththuth	அமைத்துத்துத்து
amaithuth	அமைத்துத்துத்துத்
amaitthuth	அமைத்துதுதுதுத்து
amachankalil	அமச்சங்களில்
amasankalil	அமசனங்களில்
amsangalil	அம்சங்களில்
amsangkalil	அம்சங்களில்
amchankalum	அம்சங்களும்
amsangalum	அம்சங்களும்
amsankalum	அம்சங்களும்
amsangalaik	அம்சங்களைக்களைகை
amsangazhaik	அம்சங்களைக்
amsanggalaik	அம்சங்களைக்
amsaththai	அம்சத்தை
amchamaana	அம்சமான
amchamana	அம்சமான
amsamaana	அம்சமான
ambalavaanar	அம்பலவானர்
ambalavanar	அம்பலவனர்
ampalavaanar	அம்பலவானர்
ayana	யயநான
ayirai	அயிறை
airoappiya	ஐரோப்பியாயைய்
airoopiya	ஐரோபியாய
airoppiya	ஐரோப்பியிய்யைய்
ayrooppiya	அயோருப்பியிய்யைய்
ayropiya	அரோபியாயையாயையா
europe	நோரபப்பிப்ப்ப்
arakka	அறக்காக்கா்கா
arrakka	அறக்கக்க
arakkan	அறக்கண்ணன்
arrakkan	அறக்கண்கண்டன்
arakku	அறக்கு
araku	அரகு
aruppukkoattai	அறுப்புக்கோட்டை
aruppukkoottai	அறுப்புக்கூட்டை
aruppukkottai	அறுப்புக்கொட்டை
aruppukoattai	அறுப்புகோட்டை
arumbu	அரும்பு
arppaniththa	அற்ப்பநித்த்த்
ariyappatta	அறியப்பட்ட
ariyappattadhu	அறியப்பட்டது
ariyappattathu	அறியப்பட்டது
ariyappattu	அரியப்பட்டு
ariyaar	அரியாரார்
ariyum	கரியும்
arivadhu	அறிவது
arivathu	அறிவது
arivan	அறிவன்
arivin	அறிவின்
arivar	அறிவர்
arivin	அறிவின்
arivippugalai	அறிவிப்புகளை
arivippukalai	அறிவிப்புகளை
arivil	அறிவில்
arivulla	அறிவுள்ள
arupathaam	அறுபதாம்
arupathugalil	அருபதுகளில்
arupathukalil	அருபதுகளில்
arupaththu	அறுபத்து
aupaththu	அவைப்
araiguuval	அறைகுவல்வள்
araikooval	அறைகோவளு
araikuuval	அறைகுவளுவள்
alagaal	அலகால்
alakaal	அலகால்
alagil	கழில்லில்
alakil	கழில்
aliyum	யிலியும்
alavaal	அளவாலள்
alavukadandhdha	அவவுகடந்தன்
alavukadandhtha	அவவுகடந்த்த
alavukadantha	அவவுகடன்த
alavukatandhdha	அவவுகடந்தந்த
alavukatandhtha	அவவுகடந்த்த்த
alavugalum	அளவுகளும்
alavukalum	அளவுகளும்
alavugalai	அளவுகளை
alavukalai	அளவுகளை
alavugal	அளவுகள்
alavukal	அளவுகள்
alavukkuch	அவவுக்குச்சுச்சுச்
alavukkup	அளவுக்குப்புப்
alavukkum	அளவுக்கும்
alavulla	அலவுள்ள
alagi	நாளிகி
alaki	அழகிகி
azhagi	அழகிகி
azhaki	அழகி
alaginai	அழகினை
alakinai	அழகினை
alazhaginai	அழகினையை
azhaginai	அழகினை
azhakinai	அழகினை
alagin	லகினின்
alakin	அலகிகின்
azhagin	அழகின்
azhakin	கழகின்
alakiyaana	அலகியான
alazhagiyaana	அழகியானான
azhagiyaana	அழகியான
azhakiyaana	அழகியான
alagil	கழில்லில்
alakil	கழில்
azhagil	கழகில்
azhakil	சழக்கில்
azhiththadhu	அழித்தது
azhiththathu	அழித்ததுது
azhiththana	அழித்தன
azhiththanar	அழித்தனர்
azhiththavan	அழித்தவன்
aliththaan	அழித்தான்நான்
azhiththaan	அழித்தான்நான்
aliththaar	அளித்தார்
azhiththaar	அழித்தார்
aluththi	ஆலுத்தி
azhuththi	அழுத்தி
alaippu	ஆளைப்பு
azhaippu	அழைப்பு
avathaaranggalil	அவதாரங்களில்
avathaarangkalil	அவதாரங்களில்
avathaaranggal	அவதாரங்கள்
avathaarangkal	அவதாரங்கள்
avathaaraththil	அவதாரத்தில்
avatar	அவடரரர்
avathaar	அவதாரார்
avanudaiya	அவனுடையை
avaridam	அவரிடம்
avatrtrudan	அவற்றுடன்
avatrudan	அவற்றுடன்
avattrudan	அவற்றுடன்
avalukku	அவளுக்கு
avaludan	அவளுடன்
availaik	அவைலைகை
avalaik	அவளைகை
avalaith	அவலைத்தை
avalaip	ைப்பைை
avvagai	கவ்வகை
avvakai	வவ்வகைை
aagast	யாஸ்டாஸ்ட்ஸ்டாஸ்ட்ட்டாஸ்ட்டஸ்டாஸ
aagust	கூஸ்ட்டு
aakast	ரகஸ்ட்ட்ட்ட்ட்ட்ட்ட்ட்ட்ட்ட்ட்ட்
agast	கச்ட்ட்ட்ட்ட்ஸ்ட்ட்ட்ஸ்டர்ஸ்டர்ஸ
august	ருசு
auuguust	ூஷ்டு
avgast	ஆவ்காஸ்ட்ட்ட்டு
awgast	ஆவ்காஸ்ட்ட்ட்ட்ட்ட்ட்ட்ட்ட்ட்ட்ட
aagivida	அகிவிடிடை
aagivita	அகிவிடடட்ட
aakivida	ஆகிவிடிட
aagividum	அகிவிடும்
aagivitum	ஆகிவிடும்
aakividum	ஆகிவிடும்
aaakspoard	ஆக்ஸ்போர்ட்ட்ட்ட்ட்ட்ட்ட்ட்ட்ட்ட
aaksfoard	ஆக்ச்போர்ட்டு
aakspoard	ஆக்ஸ்போர்ட்ட்ட்
oxford	ஞாச்பர்ட்ட்ட்ட்
aasiramaththirku	ஆசிரமத்திற்கு
aasiramaththiruku	ஆசிரமத்திருக்கு
aasiramaththil	ஆசிரமத்தில்
aachiramam	ஆசிரமமம்
aashram	காரமம்மம்
aasiramam	ஆசிரமமம்
aasram	வாரமம்ம
ashram	காராம்மம்மாம்மம்ம
ashramm	காஷ்மம்ம்
asram	யாராமாம்ம்ம்ம்மம்ம்
asramm	கார்ம்மம்ம்
aasiriyaraakap	ஆசிரியராகப்
assiriyaraagap	அசிரியராகப்
aasiriyaraakavum	ஆசிரியராகவும்
assiriyaraagavum	அசிரியராகவும்
aanchchanaeyar	ஆஞ்சநேயர்
aanjaneayar	அஞ்சனேயர்
aanjchanaeyar	ஆஞ்சநேயர்
anjaneyar	அஞ்சனேயர்
aadippoora	ஆடிப்போரூர்
aadippooram	ஆடிப்போரம்
aadugalil	ஆடுகளில்
aadukalil	ஆடுகளில்
aadubavar	ஆடுபவர்
aadupavar	அடுபவர்
aadum	தாடுமும்
aaduvar	ஆடுவரர்
aatti	தார்டி
aattin	வட்டினின்
aangalidam	ஆங்களிடம்
aangalitam	ஆங்களிடம்
aankalitam	ஆங்களிடம்
aangalin	அங்களினின்
aankalin	அங்களினின்
aangalilum	ஆங்களிலும்
aankalilum	ஆங்களிலும்
aangalukkaana	ஆங்களுக்கான
aangalum	கங்களும்
aankalum	ஆங்களும்
aangalae	ஆங்களே
aankalae	ஆங்களே
aangalaik	ஆங்களைகைகை
aankalaik	ஆண்களைகை
aangak	ஆங்ககாகக்கங்க
aangal	ஆங்கள
aankal	ஆங்கள்
aanda	அந்த்த்தா
aanta	ஹ்்வ
aandathu	ஆண்டது
aantathu	ஆண்டது
aandanar	ஆண்டனர்
aantanar	ஆண்டனரனரர்
aandarchan	அந்தர்சண்டன்
aandarsan	ஆண்டர்சன்
andarshon	அந்தர்சன்
andarson	அந்தர்சன்
anderson	அந்தர்ஜோன்
aandavar	அன்டவர்
aantavar	அந்தவரர்
aandilirunththu	ஆண்டிலிருந்து
aandilirunthu	ஆண்டிலிருந்து
aandae	தண்டே
aantae	அந்தே
aatharavaaga	ஆதரவாக
aatharavaaka	ஆதரவாக
aatharavaagach	ஆதரவாகச்
aatharavaakach	ஆதரவாகச்சசச்சச்ச்சச்ச்சச்ச்சச்ச்
aatharvaagach	அதர்வாகச்சகச்ச்சச்ச்
aatharikkavillai	ஆதரிக்கவில்லை
aathmaa	ஆத்மாம்மாம்ம்ம
aathmaavin	ஆத்மாவின்
aathmaavil	ஆத்மாவில்
aanthai	கந்தை
aanththai	ஆந்தை
aanaimalai	ஆணைமலை
aan	அவா
aana	ஆன்
ain	வைனின்
ainn	்நைன்ன்ன்ன்ன்னன்
an	அனனனனனன
ann	ந்ன்ன்ன்ன்ன்ன்ன்ன்ன்ன்ன்ன்ன்ன்ன்
ein	யென்னி
einn	யன்னி
en	யனன்
enn	ன்னன்
on	ஓநோனோன்னோன்
aanmaa	ஆன்மாம்மா
anema	காமமாமம்மமாமம்
aniima	ஆணிமமை
anima	ஆணிமாம்ம்
animaa	அணிமாம்மாா
anma	காம்மம்ம்மம்ம்ம
enima	எனிமம்
aanmaavukku	ஆன்மாவுக்கு
aapirikkaa	ஆபிரிக்கா்
africa	தப்ரிக்காச்சிக்கப்
aappirikkaavilum	ஆப்பிரிக்காவிலும்
aappirikkavilum	ஆப்பிரிக்கவிலும்
africaavilum	அபிரிக்காவிலும்
aappirikkaavukku	ஆப்பிரிக்காவுக்கு
africaavukku	ஆபிரிக்காவுக்கு
africavukku	பெரிக்கவுக்கு
aappirikkaavai	ஆப்பிரிக்காவை
africaavai	பெர்சிகாவை
africavai	பெர்சிகவை
aayeena	ஆயின்
aayina	கையானான
aayeenar	ஆயினரன்ரர்
aayinar	ஆயினர்
aayera	அயர்ரார
aayira	அயிறாரார
aayerakkanakkil	ஆயிரக்கணக்கில்
aayirakkanakkil	ஆயிரக்கணக்கில்
aayeraththirkum	ஆயிரத்திற்கும்
aayiraththirkum	ஆயிரத்திற்கும்
aayeraththu	ஆயர்
aayiraththu	ஆயிரத்து
aayeraththai	ஆயெரத்தை
aayiraththai	ஆயிரத்தை
aayeram	வயரரமம்
aayiram	ஆயிரம்
ayil	ையில்
oial	ஓயயல்லாயல்லாயல்லாயல்லாயல்லாயல்லா
oil	ாயில்லூவெல்லி
oill	ாயில்
ouil	ூசிலில்
ouuil	ூளிலிலில்
oyal	ஊயல்லல்
aayulai	அயுளை
aaitha	ஆத்தாதி
aaytha	ஆத்த
aaivukalin	ஆய்வுகளின்
aayuvugalin	ஆயுவுகளின்
aayvugalin	ஆய்வுகளின்
aayvukalin	ஆய்வுகளின்
aaivukalukku	ஆய்வுகளுக்கு
aayvugalukku	ஆய்வுகளுக்கு
aayvukalukku	ஆய்வுகளுக்கு
aaivukalaiyum	ஆய்வுகளையும்
aayvugalaiyum	ஆய்வுகளையும்
aayvukalaiyum	ஆய்வுகளையும்
aaivukal	அய்வுகள்
aayvugal	ஆய்வுகள்
aayvukal	அய்வுகள்
aaivuk	அறிவுக்
aayvuk	அய்வுக்குக்
aaivukkatturai	ஆய்வுக்கட்டுறை
aayvukkatturai	ஆய்வுக்கட்டுறை
aaivukkatturaikal	ஆய்வுக்கட்டுறைகளை
aayvukkatturaigal	ஆய்வுக்கட்டுறைகள்
aayvukkatturaikal	ஆய்வுக்கட்டுறைகள்
aaivukkaaaka	ஆய்வுக்காககக
aayvukkaaga	ஆய்வுக்காக
aayvukkaaka	ஆய்வுக்காக்காக
aaivukkaana	ஆய்வுக்கான
aayvukkaana	ஆய்வுக்கான
aaivukku	ஆய்வுக்கு
aayvukku	ஆய்வுக்கு
aaivum	கைவும்
aayvum	கைவும்
aariyar	ஆரியர்
aariyargalin	ஆரியர்களின்
aariyarkalin	ஆரியர்களின்
aarppaattangalai	ஆற்பாட்டங்களை
aarppaattanggalai	ஆப்பாட்டங்களை
aarppaattangkalai	ஆற்பாட்டங்களை
aarppaattangal	ஆர்ப்பாட்டங்கள்
aarppaattanggal	ஆர்ப்பாட்டங்கள்
aarppaattangkal	ஆர்ப்பாட்டங்கள்
aarppaattam	ஆர்ப்பாட்டம்
aarvaththil	ஆர்வத்தில்
aarvaththai	ஆர்வத்தை
aarvaththaik	ஆர்வத்தைக்கை
aarvamum	கர்வமும்
aarae	தேரேரே
aarkaadu	அர்காடு
aatkaadu	ஆட்காடுடு
arcod	கார்கோடோடோடோடோடோடோடோடோடோடோடோடோடோ
aatralaal	ஆற்றலால்
aatrtralaal	ஆற்றலால்
aatrtralil	ஆற்றலில்லில்
aattralil	ஆற்றலில்
aatrtralulla	ஆற்றலுள்ள
aattralulla	ஆற்றலுள்ள
aatrtru	அற்று
aattru	அற்று
aatrtrukku	ஆற்றுக்கு
aattrukku	ஆற்றுக்குக்கு
aalayangalin	ஆலயங்களின்
aalayanggalin	ஆலயங்களின்
aalayangkalil	ஆழயங்களில்
aalayankalin	ஆலயங்களின்
aalayangalai	ஆழயங்களை
aalayanggalai	ஆழயங்களை
aalayangkalai	ஆழயங்களை
aalayankalai	ஆழலங்களை
aalayath	கலையதததததததததததததததததததததததததததத
aalayaththirku	ஆழயத்திற்கு
aalayatthirkku	ஆழயத்திற்கு
aalayaththukku	ஆழயத்துக்கு
aalayamum	ஆழயமுமும்
aalaiyam	ஆலையம்
aalaiyum	காலையும்
aaloachanaikalaiyum	ஆலோசனைகளையும்
aaloasanaigalaiyum	ஆலோசனைகளையும்
aaloasanaikalaiyum	ஆலோசனைகளையும்
aaloasanaikalayum	ஆலோசனைகளையும்
aalosanaigalaiyum	ஆலோசனைகளையும்
aalosanaikalayum	ஆலோசனைகளையும்
aaloachanaikal	ஆழோசனைகள்
aaloasanaigal	ஆலோசனைகள்
aaloasanaikal	ஆலோசனைகள்
aalosanaigal	ஆலோசனைகள்
aalosanaikal	ஆலோசனைகள்
ikkaruvi	இக்கருவி
ikkaruviyai	இக்கருவியை
ekkoottaththil	இக்கூட்டத்தில்
ikkoottaththil	இக்கோட்தத்தில்
engkaethaan	இங்கேதான்
ingaethaan	இங்கேதான்
ingkaethaan	இங்கேதான்
ichaikkaruvi	இசைக்கருவி
isaikkaruvi	இசைக்கருவி
ichaikkaruvikalai	இசைக்கருவியலை
isaikkaruvigalai	இசைக்கருவிகளை
isaikkaruvikalai	இசைக்கருவியலை
ichaikkaruviyai	இசைக்கருவியை
isaikkaruviyai	இசைக்கருவியை
inchchi	இன்சி
inchi	ஞாஞ்சி
injchi	இஞ்சி
idaodhikkeedu	இடந்திக்கெடு
idaodhukkeedu	இடந்துக்கீடு
idaothukkeedu	இடந்தொக்கீடு
idaththila	இடத்தில்
idaththilum	இடத்திலும்
idiththu	இடித்து
vittu	விட்டு
idippu	இடிப்பு
idugaigalil	இடுகைகளில்
idaiyooraaga	இடையோராக
idaiyooraaka	இடையோராக
idaiyaeyaana	இடையேயான
inaiyaanadhu	இணையானது
inaiyaanathu	இணையானது
inaiyaanavai	இணையானவை
idhanaal	இதனால்
ithanaal	இதனால்
idhanaalthaan	இதனால்தான்
ithanaalthaan	இதனால்தான்
idhara	எதரராா
itara	எட்ாரராராராபராதாராரார
ithara	எத்தரர்
othar	ஒதரதரர்
othara	நோதரரர்
other	கோரார்
othera	ஒத்தரர
idhazhaaga	இதழாக
ithalaaka	இதலாக
ithazhaaka	எதழாக
idhoa	யியோகோ
ithoa	யூடோகோ
iththiraippadaththin	இத்திரைப்படத்தின்
iththiraippadaththai	இத்திரைப்படத்தை
iththeevil	இத்தீவில்
iththeevu	இத்தேவு
indana	இந்தன
indiana	இந்தியனனான
inidiiana	இநிடியினான
inidiyana	இநிடியனை
intiyana	இந்தியணனான
indiavirkul	இந்தியவர்க்குள்
inthiyaavirkul	இந்தியாவிற்குள்
inththiyaavirkul	இந்தியாவிற்குள்
indiavil	இந்தியாவில்
inthiyaavil	இந்தியாவில்
inththiyaavil	இந்தியாவில்
indiavai	இந்தியாவை
inthiyaavai	இந்தியாவை
inththiyaavai	இந்தியாவை
indhuk	ய்ந்துக்கு
indhukkalukku	இந்துக்களுக்கு
innigazhvukku	இந்நிகள்வுக்கு
inthnikalvukku	இந்நிகள்வுக்கு
innigazhvai	இந்நிகழ்வை
inthnikalvai	இந்நிகள்வல்வை
inniruvanangal	இந்நிருவனங்கள்
inniruvananggal	இந்நிருவனங்கள்
inthniruvanangkal	இந்நிருவனங்கள்
inniruvanam	இந்நிருவனமம்
inthniruvanam	இந்நிருவனமாம்
innoayai	இந்நோயை
innooyai	எண்ணோயை
inthnoayai	இந்நோயை
inaththavar	இனத்தவர்
enra	என்றே
entra	ஏன்று
inam	யினம்மம்மம்ம்
yenra	யேந்துராான்
inavaatham	இனவாதம்
inaviruththi	இனவிருத்தி
inaiya	இணையையை
incoa	யின்சோ
ingaa	யங்காங்கா
inkaa	யங்கா
innal	இந்நல்லாலால்
innel	இந்நலல்
innalgal	இந்நல்கள்
innalkal	இந்நல்கள்
innelkal	இந்நெல்கள்
innichai	இந்நிசை
innisai	இந்னிசை
innichaik	இந்நிசைகை
innisaik	இந்நிசைகை
innum	யின்னும்
indralavilum	இன்றலவிலும்
inralavilum	இன்றலவிலும்
intralavilum	இன்றலவிலும்
indralavum	இன்றலவும்
inralavum	இன்றலவும்
intralavum	இன்றலவும்
indri	ந்திரி
inri	ன்றி
intri	க்டி
indrith	இன்றித்தித்தித்தித்தி
inrith	வினிறத்த்த
intrith	கன்றித்தித்தித்தி
indriyum	இன்றியும்
inriyum	யின்றியும்
intriyum	இன்றியும்
ippadai	இப்படை
ippatai	இப்படை
ipparavai	இப்பரவை
ipparavaigal	இப்பரவைகளை
ipparavaikal	இப்பரவைகள்
ippalli	இப்பல்லில்
ippalliyil	இப்பல்லியில்
ippaadhai	இப்பாதை
ippaathai	இப்பாதை
ippaadhaiyil	இப்பாதையில்
ippaathaiyil	இப்பாதையில்
ipporutkal	இப்பொருட்கள்
ippoathaiya	இப்போதையைய்
ibraahim	எப்ராஹிமிம்
ibraakim	இப்ராகிம்
ibrahim	இப்ராஹிமிம்
ipraakim	இப்ராகிம்
imayamalaiyin	இமயமலையின்
himachala	ஹிமச்சலாலலால்ல
imaachchala	இமாச்சலல்
himachalap	ஹைமசலப்பலாபால்
imaachchalap	இமாச்சலப்பல்பல்
immakkal	இம்மக்கள்
iyakkaththaich	இயக்கத்தைச்
iyakku	இயக்கு
eiyalpaiyum	இயல்பையும்
iyalbaiyum	இயல்பையும்
erattippaaka	ஏறட்டிப்பாக
irattippaaga	இரட்டிப்பாக
irukka	இருக்காக
koodaathu	கூடாது
koodadhu	கோடது
koodum	கோடும்
kutatu	குட்டத்
irukkap	இருக்கப்ப
irukkavillai	இருக்கவில்லை
irukkavoa	இருக்கவோவோ
irukkumpoathu	இருக்கும்போது
iruchakkara	இருசக்கரர
irusakkara	இருசகக்கரராகர்
iruppai	இருப்பை
iruppaiyum	இருப்பையும்
irumal	இருமல்லல்லல்
irumurai	இருமுறை
irumbuth	இரும்புதுத்துதுதததுத்
irumputh	யிரும்புத்துத்துத்து
irumbub	யிரும்புப்புப்புப்புப்புப்புப்பு
irumpup	யிரும்புப்புப்
irugi	இருகி
iruki	இருகி
irugik	ுகிகிகி
irukik	க்கிக்கிக்
ilakka	இலக்கக்காக்க
ilakkam	இலக்கம்மகம்
ilakkin	இலக்கின்
ilakkil	இலக்கில்
ilatcha	இலட்சாச்சா்்ச்ச
latcha	லாட்ச
ilatchaththirkum	இலட்சத்திற்கும்
ilatchiyaththirkum	இலட்சியத்திற்கும்
latchaththirkum	லட்சத்திற்கும்
latchiyaththirgum	லட்சியத்திற்கும்
ilatchumi	இலட்சுமி
lakshmi	லக்சிஸ்மி
latchchumi	லட்சுமிமி
illaiyena	இல்லையெனெனேன்
illaiyenil	இல்லையெனில்
ilamvayathilaeyae	இலம்வயாதியேலை
ilamvayathileayea	இலம்வயாதியேல்
ilamvayidhilaeyae	இலம்வயிதீலியே
ilanthu	இழந்து
izhanththu	இழந்து
izhanthu	இழந்து
evatrtrukkum	இவற்றுக்கும்
ivatrtrukkum	இவற்றுக்கும்
ivatrukkum	இவற்றுக்கும்
evaa	அவாவா
ivaa	யவவாவா
evai	வை
ivai	யவவை
evaikalaal	இவைகளால்
ivaikalaal	இவைகளால்
evaikalil	இவைகளில்
ivaigalil	இவைகளில்
evaikalukku	எவைகளுக்கு
ivaigalukku	இவைகளுக்கு
evaikalae	வைகளேலேே
ivaigalae	இவைகளே
evaikalai	ஏவைகளை
ivaigalai	இவைகளை
evaikalaith	ஏவைகளைத்தைத்
ivaigalaith	இவைகளைதைத்
evaithaan	ஈவைத்தானான்
ivaithaan	இவைதானான்
evaiyellaam	ஈவையல்லாம்
ivaiyellaam	இவையல்லாம்
ivvaiyellaam	இவையெல்லாம்
evaiyae	ஈவையே
ivaiyae	இவையே
ivvaiyae	இவையே
eesanin	ஈசனினின்
eesan	ஈசன்னன்
eesal	ஈசலலலலல்லஸ்ல்லாலல்லிலல்
eeya	ஈயேயே
iiya	ேய்
iya	ுய்
eerppu	ஈ்பு
ierppu	ஈர்ப்பு
irppu	ம்ப்பு
eerppup	எர்ப்புப்புப்புப்புப்புப்புப்புப
eerppuvisai	ஏற்புவிசைசை
eeru	ஈரு
eerugalai	ஏறுகளை
eerukalai	ஏறுகளை
eevu	ஈவு
evu	வுவு
ugandha	ரகாந்தாந்தாந்த
ukandha	வுந்தாண்தாந்தா
ungantha	உங்கந்தந்தந்த
ugandhavai	உகந்தவை
ukandhavai	உகாந்தவை
ukanththavai	உகந்தவை
udalilum	உடலிலும்
udalil	தொழலில்
udalai	ஊடலை
vittu	விட்டு
udalaik	உடலைகை
udalnalam	உடல்நலமமம்
udaindhadhu	உடைந்தது
udainthathu	உடைந்தது
utkolluthal	உட்கொள்ளது
utkollum	உட்கொள்ளும்
utkolvathu	உட்கொள்வது
udpuramaaka	உட்புறமாக
utpuramaaga	உட்புரமாக
utpuramaaha	உட்புரமாக
udpuram	உட்புரமம்
utpuram	உட்புரமம்
unarvaaga	உணர்வாக
unarvaaka	உணர்வாக
vagaigalai	வகைகளை
vagaikalai	வகைகளை
vakaikalai	வகைகளை
unavugalil	உணவுகளில்
unavukalil	உணவுகளில்
unavugalum	உணவுகளும்
unavukalum	உணவுகளும்
unavugalaich	உணவுகளைச்
unavukalaich	உணவுகளைச்
uanvugalaiyum	அன்வுகளையும்
unavugalaiyum	உணவுகளையும்
unavukalaiyum	உணவுகளையும்
unavukkaaga	உணவுக்காக
unavukkaana	தனவுக்கான
unavuch	ுனவுச்சுச்சுச்
unavudan	உணவுடன்
unavutan	உணவுடன்
unda	உண்ட
unnda	யன்ட
unta	உண்ட
undaanadhu	உண்டானது
undaanathu	உண்டானது
untaanathu	உண்டானது
unththum	உந்தும்
unthum	உந்தும்
uppsala	நப்பாலலால
uppsalaa	உப்பசாலாலாாாலாால
upsala	வப்பலாலா
upsalaa	உப்பலாாாாாாாாாாாாாாாாாாாாாாாாாாா
upsalla	உப்பல்லா
uuppsala	ஊப்பாலலவலலலல
uuppsalaa	ஊப்பலாலாாாலலாலலா
uupsalla	ஊப்ளல்லால்லா
uppu	உப்பு
uppugalum	உப்புகளும்
uppukalum	உப்புகளும்
uppum	ஞ்சும்ம்
umathu	உமது
umai	ைமைமைமைமைமைமைமைமைமைமைமைமைமைமைமைம
ummaa	ௌமா
uyirinamaaga	உயிரினமாக
uyirinamaaka	உயிரினமாக
uyirinam	உயிரினம்
uyirmai	உயிர்மை
uyirvaala	உயிர்வால்லா
uyirvaazha	உயிர்வாழ
uyirvaalum	உயிர்வாலும்
uyirvaazhum	உயிர்வாழும்
uyilil	செயிலில்
uyil	ேயில்
uriththaana	வரித்தானான
urga	சுக்க
uruga	உருகுகாகப்
uruka	ருக்குகாக
urukkiya	உருக்கியை
uruvappadaththai	உருவப்படத்தை
uruvappataththai	உருவப்படத்தை
uruvappadam	உருவப்படமமம்
uruvappatam	உருவப்படம்
uruvaagak	உருவாககககககககககககககககககககககககககக
uruvaakak	ருவாகககககககககககககககககககககககககககக
uruvaagavillai	உருவாகவில்லை
uruvaakavillai	உருவாகவில்லை
uruvaagavum	உருவாகவும்
uruvaakavum	உருவாகவும்
uruvaagiyulla	உருவாகியுள்ள
uruvaakkaththin	உருவாக்கத்தின்
uruvaakaththirku	உருவாகத்திற்கு
uruvaakkaththirku	உருவாக்கத்திற்கு
uruvaakaththilum	உருவாகத்திலும்
uruvaakkaththilum	உருவாக்கத்திலும்
uruvaakkappadum	உருவாக்கப்படும்
uruvaakkamum	உருவாக்கமும்
uruvaakkal	உருவாக்கள்
uruvaakkaamal	உருவாக்காமல்
uruvaakkuvatharku	உருவாக்குவதற்கு
uruvaakkuvathu	உருவாக்குவது
uraiyaadalgalil	உரையாடல்களில்
uraiyaadalkalil	உரையாடல்களில்
uraiyaatalgalil	உரையாடல்களில்
uraiyaadalgalai	உரையாடல்களை
uraiyaadalkalai	உரையாடல்களை
uraiyaatalgalai	உரையாடல்களை
urangaamal	உறங்காமல்
urangkaamal	உறங்காமல்
kondirundha	கொண்டிருந்த
kontirunta	கொண்டிருந்த
kontiruntha	கொண்டிருந்த
uravaaga	உரவாக
uravaaka	வரவாக
urudhiyaana	உறுதியான
uruthiyaana	உறுதியான
urudhiyaanathum	உறுதியானதும்
uruthiyaanathum	உறுதியானதும்
uruppu	உறுப்பு
uruppugalin	உருப்புகளின்
uruppugalukku	உறுப்புகளுக்கு
uruppugalukkum	உறுப்புகளுக்கும்
uruppugalaiyum	உறுப்புகளையும்
uruppugal	உறுப்புகள்
uruppukku	உறுப்புக்கு
uruppukkum	உருப்புக்கும்
uruppum	உருப்பும்
ulaginai	உலகினை
ulakinai	உலகிணை
ulagaip	ுலகைப்பைை
vaanoordhi	வானூர்த்தி
vaanoorthi	வானூர்த்தி
vaanuurthi	வாணுர்த்தி
vaanuurti	வானுருட்டி
vanurti	வனுரற்ற்
varukindrana	வருகின்றன
varukinrana	வருகின்றன
uloom	லுமோம்
ulum	ைளும்
ulladakka	உள்ளடக்க
ullatakka	உள்ளடக்க
ulladakkamum	உள்ளடக்கமும்
ullatakkamum	உள்ளடக்கமும்
ulladakkum	உள்ளடக்கும்
ullatakkum	உள்ளடக்கும்
ullirunththu	உள்ளிருந்து
ullirunthu	உள்ளிருந்து
ulvaanggiya	ஊு்வாங்கிய்
ulvaangkiya	ஊழ்வாங்கிய
ulvaankiya	உள்வாங்கிய்
ulaippukku	உழைப்புக்கு
ulaipputhaan	உழைப்புதான்
uzhaippukku	உழைப்புக்கு
oodaka	ஓடாககககககககககககககககககககக
udaka	நடாகக்கப்
uudaaka	ஊடாககககககககககககககககககககககககககககக
uudaka	நூடாகககககககககககககககககககககககககககக
oodagaththil	ஓடகத்தில்
oodakaththil	ஓடகத்தில்
udagaththil	உடகத்தில்
uudakaththil	உடகத்தில்
oodagaththai	ஓடகத்தை
oodakaththai	ஓடகத்தை
udagaththai	உடகத்தை
uudakaththai	ஊடகத்தை
oodagap	னப்பப்ப்ப்ப்ப்ப்ப்ப்ப்ப்ப்ப்ப்
oodakap	கப்பாபாப்
uudagap	கபபபப்பபாப
uudakap	கப்பாபாப்ப
oodagam	ஓடகமம்
uoodagam	கூடமகம்
uudakam	கூதமகம்
oothaa	ஊதாதா
uuthaa	யுதா
ooraga	ஓரககககரகாகாடாக
uooraga	நூரகக
uuraaka	வராகககககககக
oorae	சுரேரா
uurae	சுரே
oorvalamaaga	ஊர்வலமாக
oorvalamaaka	ஊர்வலமாக
uurvalamaaka	ஊர்வளமாக
expo	எக்போப்போப்போ
yekspoa	யக்ஸ்போப்போ
enggo	க்கோங்கோ
engkoa	மங்கோ
enkoa	மங்கோனோ
esuppaaniya	எசுப்பானியாய
yesuppaaniya	எசுப்பானியாய்ய
enchchi	எஞ்சிச்சி
enchi	ஞாச்சி
enjgi	ஞ்சி
enchin	காஞ்சினின்
engine	எங்கினேன்
edukkappadaamal	எடுக்கப்படாமல்
yedukkappadaamal	எடுக்கப்படாமல்
ettappadum	எட்டப்படும்
etttappadum	எட்டப்படும்
ettaavathu	ஏட்டாவது
ettiyathu	ஏட்டியது
yettiyathu	ஏட்டியது
ennikkai	எண்ணிக்கை
yennikkai	எண்ணிக்கை
ennikkaiyaana	எண்ணிக்கையான
ennikkaiyilum	எண்ணிக்கையிலும்
ennikkaiyil	என்னிக்கையில்
ethargaaka	எதற்காக
etharkaaga	எதற்காக
etharkaaka	எதற்காக
ethiraali	எதிராலி
ethiraaliyin	எதிராலியின்
edhirkka	எதிர்க்க
ethirkka	எதிர்க்க
yedhirkka	எதிர்க்க
edhirkkavillai	எதிர்க்கவில்லை
ethirkkavillai	எதிர்க்கவில்லை
yedhirkkavillai	எதிர்க்கவில்லை
edhikkavum	எதிக்கவும்
ethirkkavum	எதிர்க்கவும்
yedhirkkavum	எதிர்க்கவும்
edhirkaamal	எதிர்காமல்
ethirkkaamal	எதிர்க்காமல்
yedhirkaamal	எதிர்காமல்
yedhirkkaamal	எதிர்காமலால்
edhirpaarppu	எதிர்பார்ப்பு
ethirpaarppu	எதிர்பார்ப்பு
edhirpaarppugal	எதிர்பார்ப்புகள்
ethirpaarppugal	எதிர்பார்ப்புகள்
ethirpaarppukal	எதிர்பார்ப்புகள்
edhuvaaga	எதுவாக
ethuvaaka	எதுவாக
yedhuvaaga	எதுவாக
einid	யினிடிடிடி
enid	எனிடிடிடி
eniid	எணிதி
eynid	எநிடிடிடிடி
iinid	யினிடிடி
inid	எணிடிடிடிடிடி
iniid	கினி
iynid	நிநிடிடிடிடிடிடிடிடிடிடிடிடிடிடி
yenid	எணிடிடி
enin	னினின்
amili	நமிழீல்
amily	இளைமியி
emeli	எம்லிலி
emely	எமெலி
emile	எமில்லேலே
emili	எமிலி
emilie	எமிலி
emilii	எமிலி
emily	மெமில்லியி
imili	இமிலி
imilii	இமிலிலி
imily	இமில்லியில்
yemili	எமிலி
eytha	ேத்த
yeitha	ித்தி
eythi	ெத்தி
yeithi	எதி
eythum	நெய்தும்
yeithum	யத்தும்ம்
erinththu	ஏரிந்து
erinthu	ஏரிந்து
yerinthu	ஏறிந்து
erinththu	ஏரிந்து
erinthu	ஏரிந்து
yerinththu	ஏறிந்து
elaktraankal	எலகற்றாங்கள்
electronkal	எலெக்ட்ரொங்கள்
yekaltraankal	எக்கற்றான்கள்
elimaiyaaka	எளிமையாக
yelimaiyaaga	எளிமையாக
yelimaiyaaka	எளிமையாக
elimaiyaakak	எளிமையாகககககககககக்
yelimaiyaagak	எளிமையாகக்
yelimaiyaakak	எளிமையாகககககககககக
el	ல
yel	யில்லி
yell	ஃயில்
ezhuthiyulla	எழுதியுள்ள
yeluthiyulla	எழுதியுள்ள
ezhuthiyullathu	எழுதியுள்ளது
yeluthiyullathu	எழுதியுள்ளது
ezhuthiyullanar	எழுதியுள்ளனர்
yeluthiyullanar	எழுதியுள்ளனர்
evarukkum	ஏவருக்கும்
yavarukkum	யவருக்கும்
evarumae	ஈவருமே
yavarumae	ஞவருமேமே
eavar	ஈவர்
evar	யவ்
ever	ட்வேர்வே
ewer	மவர்வே
ivir	யவிர்ரிர்விர்ரிர்ரிர்விர்ரிர்விர
yavar	ரவர்
yevar	யவவர்
evvitha	எவ்வித்த
yavvitha	யவ்வித்த
evvithak	எவ்விதக்கக்
yavvithak	யவ்விதக்காக
evvithaththilum	எவ்விதத்திலும்
yavvithaththilum	யவ்வித்தத்திலும்
evvithamaana	எவ்விதமான
yavvithamaana	யவ்விதமதான
eavvitham	ஈவ்விதம்
evvitham	எவ்விதம்
yavvitham	யவ்விதமதம்
aegapoaka	எகப்போகக
aekapoaka	எகபோகாகோக
eekapoaka	ஈகபோகாக
ekapoaka	எகபோகாக
aekapoagam	எகபூகம்
aekapoakam	ஏகபோகம்
eekapoakam	ஈகபோகம்
ekapoakam	எகபோகம்
aengchal	ஏங்கல்
angel	கங்கில்
aanai	ை
aenai	ஈனை
yaenai	நேனை
april	ெப்ரில்
aprill	ஆப்ரில்
eepral	ஏப்ரல்
epril	ைர்ரில்
aeriya	ஆரியாய்யாய்யாயைய
eeriya	ஏரியிய
eriya	ௌரரயோயா
yeeriya	எரியைய
aerkanavae	ஏற்கனவே
earkanavae	ஏற்கனவே
eerkanavae	ஏற்கனவே
erkanavae	ஈர்கனவே
aerpadak	ஏற்படகக்ககடாக
yerpadak	ஏற்படகககககக
yerpadk	ஏற்பட்க்க
aerpadakkoodaathu	ஏற்படக்கூடாடு
yerpadakkoodiya	ஏற்படக்கூடிய
aerpadavillai	ஏற்படவில்லை
yerpadavillai	ஏற்படவில்லை
aerpadavum	ஏற்படவும்
yerpadavum	எற்படவும்
aerpadavae	ஏற்படவே
yerpadavae	ஏற்படவே
yerpadave	எர்படவேவே
aerpadaatha	ஏற்படாத
earpadaatha	ஏற்படாத
yerpadaatha	ஏற்படாததாத
aerpadaamal	ஏற்படாமல்
earpadaamal	ஏற்படாமல்
erpadaamal	எற்படாமல்
aerpaduthal	ஏற்படுதலதல்
earpaduthal	ஏற்படுதலதல்
yerpaduthal	ஏற்படுதலதல்
aerpadum	ஏற்படும்
yaerpadum	ஏற்படும்
yerpadum	ஏற்படும்
aerpaduvatharku	ஏற்படுவதற்கு
yaerpaduvatharku	ஏற்படுவதற்கு
yerpaduvatharku	இற்படுவதற்கு
aerpaduvathudan	ஏற்படுவதுடனு
yaerpaduvathudan	ஏற்படுவதுடன்
yerpaduvathudan	யற்படுவதுடனுடன்
aetrtru	ஏற்று
eattru	ஏற்று
eetrtru	ஈற்று
etrtru	த்்
aetrtrukkondathu	ஏற்றுக்கொண்டது
eattrukkondathu	ஏற்றுக்கொண்டது
aetrtrukkondanar	ஏற்றுக்கொண்டனர்
eattrukkondanar	ஏற்றுக்கொண்டனர்
aetrtrukkondu	ஏற்றுக்கொண்டு
eattrukkondu	ஏற்றுக்கொண்டு
aetrtrup	ஞற்றுப்புப்புப்ப்ப்புப்ப்ப்புப்ப
aettrup	ஏற்றுப்புப்புப்புப்புப்புப்புப்ப
eetrtrup	ன்றுப்புப்புப்ப்புப்ப்புப்ப்புப்
etrtrup	ன்றுப்புப்புப்புப்புப்
aelakiri	ஏலகிரிரி
ealagiri	ஏழகிறி
elakiri	எலகிரி
yaelagiri	ஈயகிரி
yaelakiri	ஈயகிரி
yelagiri	எழகிரிரி
ainaa	யைனா
ayna	அய்யண்
aynaa	ஆணா
ina	ெனினினினானினினினினின்
inaa	எனானா
odeesee	யூசியூ
odeesey	ஆடிசெய்யையையே
odeessei	நோசியூ
odeessey	ஜஸ்
odici	உடிசிகி
odiisii	ஊடிசிசி
odiissey	ஜோசியே
odisee	ஓடிசி
odisi	திசிசிசி
odisii	ஊடிசியி
odissei	விடிசி
odissi	ஓடிஸ்சிசி
odssi	ஓட்சிசிஸி
odysey	ஓடிசெய்யே
odysi	சிறி
odyssey	ேசெய்யே
odyssi	ஓடிசிசி
ottaga	ஓட்டகாக
ottaka	ஓட்டக்கககக்ககககககககககககககககககககக
ottagangal	ஒட்டகங்கள்
ottaganggal	ஓட்டகங்கள்
ottakangkal	ஒட்டகங்கள்
chivingi	சிவிங்கி
chivingki	சிவிங்கிங்கி
civinki	சிவிங்கி
sivingki	சிவிங்கி
ottagam	ஓட்டகம்
oththadhae	ஒத்ததே
oththathae	ஒத்ததே
oththulaikka	மொத்துளைக்க
oththuzhaikka	மொத்துழைக்க
oththulaiyaamai	ஒத்துழையாமை
oththuzhaiyaamai	ஒத்துழையாயை
ondrae	ஒன்றேரே
onrae	ஒன்றேேேரே
oppandha	ஆப்பந்தந்த
oppantha	ஒப்பந்தந்தந்த
oppandhak	ஞாப்பந்தக்்கக்
oppanthak	ஞாப்பந்தக்்
oppandhathirgu	ஒப்பந்தத்திற்கு
oppandhaththirku	ஒப்பந்தத்திற்கு
oppanthaththirku	ஒப்பந்தத்திற்கு
oppandhathil	ஒப்பந்ததில்
oppandhaththil	ஒப்பந்தத்தில்
oppanthaththil	ஒப்பந்தத்தில்
oppandhap	ஒப்பந்தபப்பப்பப்ப
oppanthap	ஒப்பந்தப்பப்பப்ப
oppandham	ஒப்பந்தம்
oppantham	ஒப்பந்தம்
omar	காமார்
omer	அமர்யர்
orumai	ஒருமைை
orumayi	ஒருமாயி
otrai	வற்றை
ottrai	மன்றை
oadhi	ரதி
oathi	தி
oodhi	ரோதி
oothi	ி
cakti	சக்டி
chakthi	சாத்தி
sakthi	சக்தி
horangal	ஹரரங்கள்
oorangal	ஓரங்கள்
orangal	ஓரங்கள்
vorangal	வருங்கள்
ooraandil	ஓராண்டில்
oraandil	ஒராண்டில்
oovar	வுர்
ovar	வோர்வார்வார்வர்
over	வவரர்
ower	ாம்ர்
overgal	ஆவர்கள்கள்
overkal	ஆவர்கள்கள்
kasappu	கசப்பு
kadandhadhu	கடந்தது
kadandhathu	கடந்தது
kadanthadhu	கடந்தது
kadanthathu	கடந்தது
kadamboor	கடம்பூர்
kadambur	கடம்பூற்றூர்
kadarkarai	கடற்கரை
katarkarai	கடற்கரை
kadarkaik	கடற்கைகை
kadarkaraik	கடர்கரைகை
kadarkaraikku	கடற்கரைக்கு
kadarkaraiyin	கடர்கரையின்
kadarkaraiyilirundha	கடற்கரையிலிருந்த
kadarkaraiyilirundhu	கடர்கரையிலிருந்து
kadarkaraiyilirunthu	கடர்கரையிலிருந்து
kadarkaraiyil	கடற்கரையில்
kadarkarayil	கடர்கரையில்
kadarkaraiyai	கடற்கரையை
kadalul	கடலுள்ளுள்ள
kadavulae	கடவுளேளை
kadavule	கடவுளேல்
kadavulgalin	கடவுள்ள்ளின்
kadavulkalin	கடவுள்களின்
kadidhangalum	கடிதங்களும்
kadithangalum	கடிதங்களும்
kadithangkalum	கடிதங்களும்
kadidhangalai	கடிதங்களை
kadithangalai	கடிதங்களை
kadithangkalai	கடிதங்களை
kadidhathil	கடிதத்தில்
kadithaththil	கடிதத்தில்
kadithatthil	கடித்தத்தில்ல்
kadidhatai	கடிதடை
kadidhaththai	கடிதத்தை
kadithaththai	கடிதத்தை
kadidhamum	கடிதமுமும்
kadithamum	கடிதமும்மும்
kadumaiyaanadhu	கடுமையானது
kadaichi	கடைச்சி
kadaisi	கடைசிகி
kataisi	கடைசிசி
kadaisiyaaga	கடைசியாக
kadaisiyaaka	கடைசியாக
kadaisiyaga	கடைசியாக
katch	க்்ச்
kootch	கோட்ச்
kutch	குட்ச்
kuutch	குட்ச்சுக்ச்சுக்ள
qootch	கோட்சுக்ச்
qutch	்ச்ச
kattamaikka	கட்டமைக்க
kattamaikkappadum	கட்டமைக்கப்படும்
kattamaikkappatta	கட்டமைக்கப்பட்ட
kattaayamaagum	கட்டாயமாகும்
kattumaana	கட்டுமான
kattumaanangal	கட்டுமானங்கள்
kattumaananggal	கட்டுமானங்கள்
kattumaanap	கட்டுமானப்ப
kattumaanam	கட்டுமானமம்
gana	கணன
kana	கண்கான்காக்கக்காக்காக்காக்கா்க
kanak	கனக்ககககககககககக்கக்
ganangal	கணங்கள்
kanangal	கணங்கள்
kanangkal	கணங்கள்ளள்
kanaththil	கணத்தில்
kanaththai	கணத்தை
kanamum	கணமுமும்
kanavaanathu	கணவானது
kanavanadhu	கணவனது
kanavanathu	கணவனது
kanetham	கணிதம்
kanidham	கனிதமம்
kanitham	கணிதம்
kanu	கனுணுகுகுகுகு
kandarindha	கண்டறிந்த
kandarindhdha	கண்டறிந்த
kandarintha	கண்டறிந்த்
kandarinththa	கண்டறிந்த்
kandarindhadhu	கண்டறிந்தது
kandarindhdhadhu	கண்டறிந்தது
kandarinthathu	கண்டறிந்தது
kandarinththathu	கண்டறிந்தது
kandarindhanar	கண்டறிந்தனர்
kandarindhdhanar	கண்டறிந்தனர்
kandarinthanar	கண்டறிந்தனர்
kandarinththanar	கண்டறிந்தனர்
kandedukkappattadhu	கண்டெடுக்கப்பட்டது
kandedukkappattathu	கண்டெடுக்கப்பட்டது
kannaottaththil	கண்ணோட்டத்தில்
kannoottaththil	கண்ணூட்டத்தில்
kannoottatthil	கண்ணூட்டத்தில்
kannottaththil	கண்ணோட்தத்தில்
kadhirveechchin	கதிர்வீச்சின்
kathirveecchin	கதிர்வீச்சின்
kathirveechchin	கதிர்வீச்சின்
canara	கணரார்
kanara	கணராராாரக்
kannaiyar	கண்ணையாயர்
kanniyar	கண்ணியர்
kabila	கபிலாள்ளிளளாள்ள
vairamuththu	வைரமுத்து
vairamuthu	வைரமுத்து
vairamuttu	வைரமுட்டு
committeeyin	கம்மீட்டீயின்
committiyin	சோம்மிட்டியின்
kamittiyin	கமிட்டியின்
committeeyil	சமிமிட்டீயில்
committiyil	சமிமிட்டியில்
kamittiyel	கமிட்டியல்
kamittiyil	கமிட்டியில்
kamba	கம்பபம்ப்ப்
kampa	கம்பம்பம்ப்ப்ப்
kambangal	கம்பங்கள்
kambankal	கம்பங்கள்
kampankal	கம்பங்கள்கள்
cumbaththin	கும்பத்தின்
kambaththin	கம்பத்தின்
kambattin	கம்பட்டின்
kampatthin	காம்பத்தின்
kampattin	காம்பட்டினின்
kamban	கம்பன்னன்னமான்கமான்னமானக்னமானனன்
kampan	கம்பன்னன்
kambaramayanaththil	கம்பரமயமாந்தில்
kambaramayanattil	கம்பரமமயத்தில்
kamparamayanattil	கம்பரமயமாட்டில்
kambarin	காம்பரினி
kamparin	காம்பரினின்
kambalaththu	கம்பளத்து
kambalattu	கம்பளட்டுட்டு
kambazhaththu	கம்பளத்து
kampalattu	கம்பள்பட்டு
companigal	சோம்பனிகள்
companygal	கம்பநியாக்
companykal	சோம்பனிகள்
kampenikal	கம்பெணிகள்
companyin	கா்பனியின்
kambeniyin	கம்பினியின்
kampeniyin	கம்பெனியின்
kayitrtrunaal	கையிற்றுநாள்
kayittrinaal	கையிற்றினால்
kayitrin	கயிற்றின்
kayitrtrin	காயிற்றின்றின்
kayittrin	காயிற்றினின்
kayitrril	காயிற்றில்
kayittril	காயிற்றில்
karan	கறன்்
karavetti	கரவிட்டிட்டிட்டிட்டி
karache	கரசசேர்
karachi	கரசிி
karachii	கரசி
karachy	கரச்சிய்
karrachi	கேராசிசி
qarache	கரசசேரேேஷே
qarachi	கரசிசிசி
qarachii	கரச்சி
qarachy	கரச்சியா்
qarrachi	கரர்ச்சிசிசி
kariyamila	கரியமில்ல
karunaakara	கருநாகரரராகரர
karunakara	கருணகரரரரர்
karunaakaran	கருணாகரணர்
karunakaran	கருணகரண்
karuththa	கருத்த்த்த்த்த்த்த்த்த்த்த்த்த்த
karuththaakkam	கருத்தாக்கம்
karuththuk	கருத்துக்குக்குக்
karuthuk	கருதுக்குக்குக்குக்கு
karuththukalin	கருத்துகளின்
karuththukkalin	கருத்துக்களின்
karuththukkal	கருத்துக்கள்
karuthukkal	கருதுக்கள்
karumpalagaiyil	கரும்பழாகையில்
karumpalahaiyil	கரும்பலக்கலை
karumpalakaiyil	கரும்பலகையில்
karumpulligal	கரும்புள்ளிகள்
karumpullikal	கரும்புள்ளிகள்
karnanin	கர்நானினின்
karnannin	கார்னனின்
karna	கர்ணாண்
karnaa	நக்்
karnnaa	கர்நானாா
karmangal	கார்மங்கள்
karmanggal	கார்மங்கள்
karmangkal	கார்மங்கள்
karmam	கற்மமம்ம்ம்
karpadhil	கற்பதில்
karpathil	கற்பதில்ல்
karpatthil	கற்பத்தில்
karpikka	கற்பிக்காக்க
karpikkappattu	கற்பிக்கப்பட்டு
vitum	விடும்ம்ம்
kalandhukolkiraargal	கலந்துகொள்கிறார்கள்
kalandhukolkiraarkal	கலந்துகொள்கிறார்கள்
kalanthukolkiraargal	கலந்துகொள்கிறார்கள்
kalanthukolkiraarkal	கலந்துகொள்கிறார்கள்
kalaai	கலாய்
kalaay	கலாய்
kalai	கலை
kalingap	கழிங்கப்பப்ப
galileo	கழில்லூ
kalyaana	காலியானான
kalyana	கல்யாணனான
kalyaanap	கல்யானப்பப்ப்
kalyanap	கல்யானபபபபபபபபபபபபபபபபபபபபபபபபபப
kalyaanam	களியாணம்
kalyanam	கல்யாணமானம்
kallaala	கல்லாள
kallala	கல்லலால
kallum	கல்லும்
kalloori	கல்லோரி
kalluri	கள்ளுறி
kaloori	கலோரி
kalloorigalilum	கள்ளூரிகளிலும்
kalloorikalilum	கல்லூரிகளிலும்
kallurigalilum	கள்ளுரிகளிலும்
kallurigazhilum	கள்ளுரிகளிலும்
kallurikalilum	கள்ளுறிகளிலும்
kallurikazhilum	கள்ளுரிகளிலும்
kalloorigalum	கள்ளூரிகளும்
kalloorikalum	கல்லூரிகளும்
kallurigalum	கள்ளுரிகளும்
kallurigazhum	கல்ளுரிகளும்
kallurikalum	கள்ளுரிகளும்
kallurikazhum	கல்லுறிகளும்
kallooriyaaga	கல்லூரியாக
kallooriyaga	கல்லோரியாகக
kalluriyaga	கள்ளுரியாகக
kalluriyaka	கள்ளுரியக
kallooriyilum	கல்லூரியிலும்
kalluriyilum	கள்ளுரியும்
muraiyil	முறையில்
kalvikkaaga	கல்விக்காக
kalvikkaga	கல்விக்கககககககக
kalvikkaka	கல்விக்ககககககக
kalvikkaana	கல்விக்கானான
kalvikkana	கல்விக்கனான
kalvippani	கல்விப்பானினி
kalviyaandu	கல்வியாண்டு
kalviyilum	கல்வியிலும்
kalviyum	கல்வியும்
kalviyae	கல்வியே
kalviye	கல்வியே
kalviyoadu	கள்வியோடு
kalviyodu	கல்வியுடுடு
kalalai	களலைை
kazhalai	கழலைை
kalutai	கழுதை
kaluthai	கழுத்தைை
kazhudhai	கழுதை
kavalai	கவலை
kavali	கவளிளி
kavalaippadum	கவலைப்படும்
kavalaippatum	கவலைப்படும்
kavalaiyae	கவலையே
kavalaiye	கவலையே
kavalaiyee	கவளையீயே
kavalaiyai	கவலையை
cofee	கோபியே
coffee	சபபி
kaahpi	காப்பி
kaattup	காட்டுப்புப்ப்ப்ப்ப்ப்ப்ப்ப்ப்ப்
kaattuyir	காட்டுயிரிரி
kaattuvadhaaga	காட்டுவதாக
kaattuvadhaga	காட்டுவதாக
kaattuvathaaga	காட்டுவதாக
kaangiradhu	காங்கிரது
kaangirathu	காங்கிரது
kaankirathu	காங்கிரது
kaangiraan	காங்கிரான்
kaankiraan	காங்கிரான்
kaangiraar	காங்கிரார்
kaankiraar	காங்கிரார்
kaanbiththadhu	காண்பித்தது
kaanbiththathu	காண்பித்தது
kaanpiththathu	காண்பித்தது
kaanbiththaar	காண்பித்தார்
kaanbithththaar	காண்பித்தார்
kaanpiththaar	காண்பித்தார்
kaathalukku	காதலுக்கு
kathalukku	கததுக்கு
kaathin	காதினின்
kathin	த்திநிக்ன்
kaathil	காதில்லில்
kathil	கதில்லி
kaathirundha	காதிருந்த
kaathiruntha	காதிருந்த
kaaththiruntha	காத்திருந்த
kaatthiruntha	காத்திருந்த
kaapoolil	காபூலில்
kabulil	கோபுலில்
kaapaatrik	காபாற்றிக்கிரக
kaappaatrik	காப்பாற்றிக்
kaappaatrtrik	காப்பாற்றிக்கிர்
kaappeedu	காப்பீடு
kappeedu	கப்பீடு
kaappuk	காப்புக்குக்
kappuk	கப்புக்குக்
kaaranangalukkaaga	காரணங்களுக்காக
kaaranangalukkaaka	காரணங்களுக்காக
karananggalukkaaka	கரரஞர்களுக்காக
kaaranaththaith	காரணத்தைத்
kaaranattait	காரணத்தைத்
kaaranatthait	காரணத்தைத்
karanaththaith	கரரணத்தைத்
kaaranamaakac	காரணமாகச்
kaaranamaakach	காரணமாகச்
karanamaakach	கரரணமாகச்
kaaranamaagattan	காரணமாகற்டன்
kaaranamaakaththaan	காரணமாகத்தான்
kaaranamaakattan	காரணமாகத்டன்்
karanamaakaththaan	கரரணமாகத்தான்
kaaranamaagap	காரணமாகப்
kaaranamaakap	காரணமாகப்
karanamaakap	கரரணமாகப்
kaaranamaagavum	காரணமாகவும்
kaaranamaakavum	காரணமாகவும்
karanamaakavum	கரரணமாகவும்
kaaranamaagave	காரணமாகவே
kaaranamaakave	காரணமாகவே
karanamaakave	கரரணமாகவே
kaaranamaagum	காரணமாகும்
kaaranamaakum	காரணமாகும்
karanamaakum	கரரணமாகும்
kaari	காரிி
cargalin	சர்களினின்
cargazhin	சார்களின்
kargalin	கார்களின்
karkalin	கற்களினின்
cargal	கேர்களாலல்
kaargal	கார்கள்
kaarkal	கார்கள்
cork	ச்க்க்்
corka	சொற்க்காக்ச்சுக்க்கர்க்்
corq	கோர்க்ச்ச்க்
corqa	கோர்க்கோக்கா்க்ச்
garg	கார்க்க்ஜிக்
kaarg	கார்க்க்
kaark	கார்க்க்
kark	கற்க்்க்க்க்்
kork	கோர்க்கோர்க்க்
qorq	டோர்க்கோ
carson	கார்சன்
kaarsan	கார்சன்
karson	கார்சன்
gardan	கார்டன்
garden	கார்டன்
kaardan	கார்டண்டன்
kaartan	கார்ட்னன்
kardan	கார்ட்டன்
kaarthikeyan	கார்திகேயன்
kaartikeeyan	கார்டிக்கீயன்
karthikeeyan	கர்திகீயன்
karthikeyan	கர்திக்கியன்
cornar	சொர்னரர்ரரர்
corner	கர்னர்ர்ரர்
kaarnar	கார்னர்நார்ரரர்
carlo	்ளோர்ளோ
carloo	கார்லர்
karloo	கர்லோ
caarloos	கார்லோஸ்வோஸஸ்
caarlos	கார்லோஸஸ்
carloos	கேரோஸ்சஸ்
carlos	சர்லோசஸ்
karloos	கார்லோஸ்கூஸ்
karlos	கேளர்ஸோஸ்்
qarlos	காராலோஸ்வரஸோஸ்
kaatrin	ற்றின்
katrin	ழற்றின்
kaattrae	காற்றேேே
kaattre	்ரே
katre	கத்்ரேரி
kaalakattangalil	காலகத்தங்களில்
kalakattangalil	கலகத்தங்களில்
kalakattanggalil	கலகத்தங்களில்
kalakattankalil	கலகத்தங்களில்
kaalakattaththilum	காலகத்தத்திலும்
kalakattaththilum	கலகத்தாத்திலும்
kaalakattaththil	காலகத்டத்தில்
kalakattaththil	கழகத்தட்டத்தில்
colonygalai	கொலனியாைைை
kaalanigalai	காலணிகளை
kaalanikalai	காலநிகளை
colonygal	கொலனியா்கள்
kaalanigal	காலநிகள்
kaalanikal	காலநிகள
kaalaththai	காலத்தை
kaalattai	காலத்தை
kaalatthai	காலத்தை
kaalaththaich	காலத்தைச்சைசை
kaalattaic	காலத்தைச்
kaalatthaic	காலத்தைச்
kaalamae	காலமே
kaalame	காலமேமேக்
kaalamee	காலமே
kaalaandil	காலாண்டில்
kaalaantil	காலாண்டில்
kaalin	லிணிகின்
kaaliya	காளியிய்ய
kaaliyaa	காளியாயா
kaavalthuraik	காவல்துறைக்கை
kaavalturaik	காவல்துறைக்கைை
kaavalthuraip	காவல்துறைப்பைை
kavalthuraip	கவல்துறைப்பைப்
kavalturaip	கவல்டுரைப்பைப்
kaavalthuraiyaal	காவல்துறையால்
kaavalturaiyaal	காவல்துறையால்
kidakkiradhu	கிடக்கிறது
kidakkirathu	கிடக்கிறது
kitakkirathu	கிடக்கிறது
kitakkiratu	கிடக்கிறது
kidangku	கிடங்கு
kidangu	கிடங்கு
kidanku	கிடங்கு
kitanku	கிடங்கு
kidandha	கிடந்தாந்த
kidanta	கிடாண்டா்டு
kidantha	கிடந்த
kitanta	கிட்டண்ட
kitantha	கிட்டந்த
kidandhanar	கிடன்தாரணர்
kidanthanar	கிடந்தனர்
kitantanar	கிடன்டனர்
vaendiya	வேண்டிய
vaendum	வேண்டும்ம்
vendia	வெண்டியினி
vendum	வெண்டும்ம்
ventiya	வெண்டியைய்
ventum	வெுந்தும்ம்
kidaikkak	கிடைக்கக்கக்
kidaikkakk	கிடைக்கக்கக்
kidaikkakkoodiya	கிடைக்கக்கூடிய
kidaikkakkudiya	கிடைக்கக்குடிய
kidaikkakudiya	கிடைக்காடுடிய
kidaikkavillai	கிடைக்கவில்லை
kadaikkaadhadhaal	கடைக்காததால்
kidaikkaadhadhaal	கிடைக்காததால்
kidaikkaathathaal	கிடைக்காததால்
kidaikkadhadhaal	கிடைக்கதால்
kidaikkaadhu	கிடைக்காது
kidaikkaathu	கிடைக்காது
kidaikkaatu	கிடைக்காட்டுடு
kitaikkaathu	கிடைக்காது
kitaikkaatu	கிடைக்காட்டுட்டு
kidaikkindra	கிடைக்கின்ற
kidaikkinra	கிடைக்கின்ற
kitaikkinra	கிடைக்கின்ற
ginniyaa	கிண்ணியா
guinea	இறி
kinniya	கிண்ணியாய்ய
kinniyaa	கின்னியா
cuba	கப்புக்்க
cubaa	சுபாக
cuuba	க்குச்சு
cuubaa	குபாகுச்
kiuba	குவப்பாவ்
kiubaa	குவாப்
kiuuba	குவைப்குவுக்கு
kiuubaa	குபாபா
kyuba	கியப்பாப்கக்கு
kyubaa	கிப்பாகக்
kyuuba	கூப்பு
kyuubaa	குப்பாக்கா
qiuba	ுய்ப்பிப்புக்கப்
qiubaa	ுகுப்பாா
qyuba	துப்ப
qyubaa	சிபுபா
cubavil	சுபவில்
kiyoobaavil	கியோபோவில்
kiyoopaavil	கியோபாவில்
kearan	கேரன்
keeran	கேரண்ணுக்காக்கக்க்க்
kiiran	கிராரான்
kiran	கிரா்னான்க்
kirann	கிராண்ண்ண்ண்்
kyran	கிராணா
qeeran	கேரண்ணா்
qiiran	கீராணாணன்
qiran	கிராண்டான்
qirann	கிராண்ண்ண்ண்ண்ண்ண்ண்ண்ண்ண்ண்ண்ண்
qyran	கிராண்
graand	கிராண்ட்ட்ட்ட்ட்ட்ட்ட்ட்ட்ட்ட்ட்
graind	கிராண்டாண்டு
grand	கினாரண்ட்்
grend	கிரின்ட்ட்ட்ட்ட்ட்ட்ட்ட்ட்ட்ட்ட்
kirand	கிராண்டாண்ட்டாண்டு
kirubai	கிருபைை
kirubhai	கிருபைை
kirupai	கிருபைை
kirishthavarkalin	கிரிஸ்தவர்களின்
kiriththavargalin	கிரித்தவர்களின்
kiritthavarkalin	கிரித்தவர்களின்
kiriththavargalum	கிரித்தவர்களும்
kiriththavarkalum	கிரித்தவர்களும்
kiritthavarkalum	கிரித்தவர்களும்
kirirththavargal	கிரித்தவர்கள்
kiriththavargal	கிறித்தவர்கள்
kiriththavarkal	கிறித்தவர்கள்
kilovukku	கிலோவுக்கு
clive	கிளிவிவ்வி
cliwe	கிளிவி
kilaiv	ை
kilive	கிளிவேவே
kilar	கிழற்றக்
kizhaar	கிழாரகரரார்காரார்காரார்
kizhar	கிழரர்க்ரர்க்கர்க்
geets	கீட்சிக்ஸ்ட்ஜ்
keat	கேட்குக்கு
keats	கேட்ஸ்ட்க்க்்
keet	கேட்டுக்கக்கக்க
keets	கேட்ச்க்க்க்க்்
kets	கதட்ச்சிட்க்்
kiids	கைட்ஸ்ஸ்ஸ்ஸ்ஸ்
kiits	கைட்ஸ்ஸ்
kits	கைட்ஸ்ஸ்ஸ்க்க்
kyts	கைட்ஸ்ஸ்ஸ்ஸ்
qeat	கேட்
qeats	ேட்சிஸ்ஸ்ட்ட்ஸ்
qiits	்ஸ்ஸ்ட்சாஸ்ட்ஸ்ஸ்ஸ்ஸ்ஸ்ஸ்ஸ்ஸ்ஸ்ஸ
qyts	டைக்ஸ்ஸ்ஸ்ஸ்ஸ்ஸ்ஸ்ஸ்ஸ்ஸ்ஸ்ஸ்ஸ்ஸ்
geethanjali	கீதஞ்சலி
keethanjali	கீதஞ்சலி
geet	கிட்டிக்க
geeta	கேட்டிக்கு
geethai	கேதை
giit	கிட்டிக்கு
giitaa	கிட்டாடா
git	காத்திக்க
gita	கிட்டிக்கு
geethaiyil	கீதையில்
geethayil	கீதையில்
keelirangi	கீழிரங்கி
keelirangki	கீழிரங்கி
keeliranki	கீழிறங்கி
keezhiranggi	கீழிரங்கி
keezhirangi	கீழிரங்கி
keezhiranki	கீழிரங்கி
kudandhai	குடந்தை
kudanthai	குடந்தை
kudippalakkam	குடிப்பளக்கம்கம்
kudippazhakkam	குடிப்பளாக்கம்
kudai	குடை
kuday	குடய்்
kutay	குடை
kudaindhdhu	குடைந்து
kudaindhu	குடைந்து
kudainthu	குடைந்து
kudayndhu	குடைந்து
kutaynthu	குடைந்து
kudaiyin	குடையின்
kudayyin	குடையின்
kutayyin	குடையின்
kudaiyil	குடையில்
kudayyil	குடையில்
kutayyil	குடையில்
good	கோடு
goodd	ஃபக்டு
goud	காடுக
gouud	காடுக்கு
gud	குடுகு
gudd	ண்டு
guud	குடுகு
kud	குடு
gunamaa	குணமாமாாாாாாாாாாாாாாாாாாாாாாாாாா
kunamaa	குணமாமாாமாமாமாமாமாகா
kuyili	குயிலி
kurudhik	குறுதிக்கி
kuruthik	குறுத்திக்கிக்
kuruvi	குறுவி
guruviyin	குருவியின்
kuriviyin	குறிவியின்
kuruviyin	குறுவியின்
kurdhu	குருத்து
kurdu	குற்துக்கு
kurthu	குர்து
kurichchi	குறிச்சி
kurichi	குறிச்சிசி
guru	குரு
kuru	குறு
kurukkup	குறுக்குப்புப்
kurukkum	குறுக்கும்
kuruvai	குறுவை
kuraindhavargal	குறைந்தவர்கள்
kuraindhdhavargal	குறைந்தவர்கள்
kurainthavarkal	குறைந்தவர்கள்
kuraindavai	குறைந்தவை
kuraindhdhavai	குறைந்தவை
kurainthavai	குறைந்தவை
kuraindhaal	குறைந்தால்
kuraindhdhaal	குறைந்தால்
kurainthaal	குறைந்தால்
kuraindhae	குறைந்தே
kuraindhe	குறைந்தே
kuraindhey	குறைந்தெய்யைய்
kurainthae	குறைந்தே
kulanggalin	குலங்களினின்
kulangkalin	குழங்களின்
kulanggalum	குழங்களும்
kulangkalum	குழங்களும்
kulanggalai	குழங்களை
kulangkalai	குழங்களை
kulanggalaiyum	குலங்களையும்
kulangkalaiyum	குழங்களையும்
kulanggal	குழங்கள்
kulangkal	குழங்கள்ளள்
kulaththirku	குலத்திற்கு
kulatthirku	குழத்திற்கு
kulaththu	குழத்து
kulatthu	குலத்து
kulaththukku	குழத்துக்கு
kulatthukku	குழத்துக்குக்கு
kulaththai	குழத்தை
kulaththi	குழத்தி
kulatthai	குழத்தை
kulamum	குலமும்
veentum	வீண்டும்ம்
vendum	வெண்டும்ம்
ventum	வெுந்தும்ம்
kuliththa	குளித்த்த்த்த்த்த்த்த்
kuliththalai	குளித்தலை
kuliththal	குழித்தல்
kuliththu	குழித்து
kulithu	குளித்து
kulirchchi	குளிர்ச்சிச்சி
kulumai	குழுமை
kulandhaai	குழந்தாய்
kulanthaai	குழந்தாய்
kulanthai	குழந்தையை
kuzhandhaai	குழந்தாய்
kuzhandhaay	குழந்தாய்யாய்
kuzhanthaai	குழந்தாய்
kuzhanthai	குழந்தை
kulukkal	குழுக்கள்
kuzhukkal	குழுக்கள்
kuva	குகவு
kuvaa	குவா
kuwaa	குவாாகு
kuantam	கௌந்தம்
kuantum	குண்டும்ம்
kuantumm	கௌட்டும்ம்
kuvandam	குவண்டம்மம்
kvantam	குவண்டம்மம்ம்
kwantam	குவண்டம்மம்ம்
quantam	குண்டம்
quantum	ுந்தும்ம்
quantumm	ைண்டும்ம்ம்
quuantam	கௌந்தம்மம்
quuantuum	கூண்டும்ம்
quuantuumm	குண்டும்ம்
qwantam	குவாண்டம்
kuvindhadhu	குவிந்தது
kuvindhathu	குவிந்தது
kuvintatu	குவிந்தடு
kuvinthathu	குவிந்தது
kuvindhu	குவிந்து
kuvinthu	குவிந்து
kuvintu	குவிந்து
ggo	குங்கு
ggoo	கோ்கோக்
goo	கோர்க்கு
gu	குகு
guu	குஜுக்கு
kuu	குகுக்ளு
koodaadhu	கூடாடுகு
koodaathu	கூடாது
koodadhu	கோடது
koodathu	கோடது
koodich	கோடிச்சிக்சிச்சிச்
koodugalil	கூடுகளில்
koodukalil	கூடுகளில்
kuudukalil	கூடுகளில்
kuutukalil	கூடுகளில்
koodumaana	கூடுமான
kuudumaana	கூடுமானான
kuutumaana	கூடுமான
koodum	கோடும்
kuudum	கூடுமும்
kuutum	கூடுமும்
koottangalin	கோட்டங்களின்
kuuttangalin	கூட்டங்களின்
kuuttankalin	கூட்டங்களின்
koottangalukku	கூட்டங்களுக்கு
kuttangalukku	குட்டங்களுக்கு
kuuttangalukku	கூட்டங்களுக்கு
kuuttankalukku	கூட்டங்களுக்கு
koottangalai	கூட்டங்களை
kuuttangalai	கூட்டங்களை
kuuttankalai	கூட்டங்களை
koottangalaiyum	கூட்டங்களையும்
kuuttangalaiyum	கூட்டங்களையும்
kuuttankalaiyum	கூட்டங்களையும்
koottangal	கூட்டங்கள்
kuuttangal	கூட்டங்கள்
kuuttankal	கூட்டங்கள்
koottath	கூட்டத்தத்த
kuuttat	கூட்டத்த
kuuttath	கூட்டத்தத்த
koottaththin	கோட்டத்தின்
kuutattin	கூட்டத்தின்
kuuttattin	கூட்டத்தின்
koottaththai	கோட்டத்தை
koottatthai	கூட்டத்தை
koottaththaith	கோட்டத்தைத்தைத்
koottatthaith	கோட்டத்தைத்தைத்
kuuttattait	கூட்டத்தைத்
kuuttattaith	கூட்டத்தைத்
koottappatta	கூட்டப்பட்ட
kuutapata	கூடப்பட்ட
kuuttappatta	கூட்டப்பட்ட
koottamum	கூட்டமும்
kuutamum	கூட்டமும்
kuuttamum	கூட்டமும்
koottam	கோட்டம்
kuutam	குலம்முக்மாுக்க
kuuttam	கூட்டம்
koottavum	கூட்டவும்
kuutavum	குடவும்
kuuttavum	கூட்டவும்
koottaaka	கூட்டாக
koottaga	கூட்டக
kuuttaaga	கூட்டாக
kuuttaaka	கூட்டாக
koottudhal	கூட்டுதல்
koottuthal	கூட்டுதல்
kootudhal	கூட்டுதல்லல்
kooththu	கொத்து
kootthu	குத்துக்கு
kuuthu	கூத்துக்குக்கு
kuuttu	உட்டு
kooraiyil	கூறையில்
koorappatta	கோரப்பட்ட
kuurapatta	கூறப்பட்டட்ட
kuurappatta	கூறப்பட்ட
koorappattirukkum	கூறப்பட்டிருக்கும்
kuurappatirukkum	கூறப்படிருக்கும்
kuurappattirukkum	கூறப்பட்டிருக்கும்
koorappattu	கோரப்பட்டு
kuurapattu	கூறப்பட்டு
kuurappattu	கூறப்பட்டு
kooravum	கோறவும்
kuuravum	கூறவும்
kooraamal	கூறாமலளல்
kuuraamal	கூறாமல்
koorai	கோறை
cool	சுலாக்சிச்சை
cul	சுலுலு
kool	கோல்
kul	குளுகுளுகுளு
kuul	குலுக்ளுகுளகு
qool	ஆலோ
qul	குல்லுக்ளுள்ள
kedukkum	கேடுக்கும்
kedum	கேடும்
calvin	ல்வின்
calwin	கல்வின்
kaelvin	கேழ்வின்ன்
kalvin	வல்வின்
kalwin	வள்வின்
kelviin	கெல்வினின்
kelvin	வள்வின்
kelvinn	கெல்வின்ன்ன்ன்ன்ன்ன்ன்ன்ன்ன்ன்ன்
kelwiin	க்ளுவின்
kelwin	கேவில்
kelwinn	கேள்வின்ன்ன்ன்
qalvin	கல்வின்
qelviin	கேல்வின்வின்
qelvin	கெல்வின்
qelvinn	கெல்வின்ன்ன்ன்ன்ன்ன்ன்ன்ன்
kaettadhu	கேட்டது
kaettathu	கேட்டது
keattathu	கேட்டது
ketadhu	கேடடு
ketathu	கேத்தத்
kettadhu	கேட்டது
kettathu	கேட்டத்து
kaettadhum	கேட்டதும்
kaettathum	கேட்டதும்
ketadhum	கேட்டதும்
ketathum	கேட்டத்தும்
kaetanar	கேட்டாளரார்
kaettanar	கேட்டனர்
kaettapoadhu	கேட்டபோது
kaettapodhu	கேட்டபோது
kaettapothu	கேட்டபோதுதுது
keattapoothu	கேட்டபொதுது
ketapodhu	கேடப்போது
ketapothu	கேடப்போது
kaettaa	கேட்டா
ketta	கப்பட்ட
kaettaar	கேட்டார்
kettar	கேட்டார்
kaettaal	கேட்டால்
keettaal	கீட்டாள்ளாள்ளாள்ளால்
ketal	கேட்டல்களகள்
kettal	கேட்டல்
kaettullaar	கேட்டுள்ளார்
kettullar	கெட்டுள்ளார்
kaendhiriya	கேந்திரியிய்
keanthiriya	கேந்திரியிய்
kendhiriya	கெந்திரியிய்
kendriya	கென்றியிய்யர்
keenl	கேன்
keenneel	கீண்ணெல்
kenel	கெனல்லில்ல்
kennel	கென்ணல்
qennel	நின்னல்
cameeo	ஸ்
cameo	சமேயோம்மியோம்மி
cameoo	சமமயோ
ccameeo	கேமியோரூவியோரூவியோரி
ccameo	சாமி
ccameoo	சமோமோம்முயோம்மான்
kaimioo	காமியோ
kaimiu	ஹைமிக்
kameeo	கமீூர்
kameo	கமீமி
kameoo	கமீமோ
kamio	கிகிமாமிக்
kamioo	கமியோமோ
keemiyoo	கீமியோயோ
kemioo	கேமியோம்
qaimioo	கொமியோமோயோமோயோ
qameo	கமமியோமியோம்மு
qamio	க்கியோயோமியோமியோமியோமியோமியோமியோ
galeen	லலன்னின்
galen	லெனினி்
gallon	காலான்
galon	காலன்னன்க
keelan	கீழானானன்
kaelu	கேளு
kelu	கேலு
kael	கேல்
kel	கேல்
kezh	கேசிச்க்க்ளக்
kaidhigalin	கைதிகளின்
kaidhikalin	கைதிகளின்
kaithigalin	கைதிகளின்
kaithikalin	கைதிகளின்
kaydhikalin	காய்திகளின்
kaythikalin	காத்திகளின்
kadhigalukku	கதிகளுக்கு
kaidhigalukku	கைதிகளுக்கு
kaidhikalukku	கைதிகளுக்கு
kaithigalukku	கைதிகளுக்கு
kaithikalukku	கைதிகளுக்கு
kaidhigalai	கைதிகளை
kaidhikalai	கைதிகளை
kaithigalai	கைதிகளை
kaidhigal	கைதிகளில்கள்
kaidhikal	கைதிகள்
kaithigal	கைதிகளில்கள்
kaidhiyaaga	கைதியாக
kaidhiyaaka	கைதியாக
kaithiyaaga	கைதியாக
kaidhiyin	கைதியின்
kaithiyin	கைத்தியின்
kaipesi	கைப்சசிசிசிசி
kaypaesi	கைப்சிசிசி
kaimaari	கைமாரி
kaimari	கைமறி
kaiyaal	ுயாலாக்
kaiyal	ுயைல்
kaiyoppamittu	கையோப்பமிட்டு
kaivasam	கைவசமமசம்
kodoora	கூட்டோர்கூர்
kodura	கூடுர்
kodooramaaga	கொடோரமாக
kodooramaaka	கொடோரமாக
koduramaga	கொடுராமககககமக
koturamaka	கோடுராமககககககககககககக
kodooramaana	கொடோரமான
koduramana	கொடுராமனமான
konarum	கோணரும்
kondirukka	கொண்டிருக்க
kontirukka	கொண்டிருக்க
kondirukkak	கொண்டிருக்கக்
kontirukkak	கொண்டிருக்கக்க்
kondirukkavillai	கொண்டிருக்கவில்லை
kontirukkavillai	கொண்டிருக்கவில்லை
kondirukkumpoadhu	கொண்டிருக்கும்போது
kondirukkumpoothu	கொண்டிருக்கும்போது
kodhikkum	கொதிக்கும்
kothikkum	கொதிக்கும்
kothikum	கொதிக்கும்
gaurila	கௌரில்லி
gaurilla	கௌரில்லா
gauurilla	கௌரில்லா
gorila	கோரில்ல
gorilla	கோரில்லால்ல்ல
gorrila	கோரில்லி்
gorrilla	கோரில்லாம்ள
govrilla	கோவில்லா
gowrila	கௌரில்லிலா
gowrilla	கோரில்லா
guarrilla	காரில்லிலாம்ல
guerilla	குரில்லா
guerrila	குற்றில்லாய்லில்
guerrilla	குற்றில்ல
gureila	குரேலா
gurila	குரில்லக்கால
gurilla	குறில்லா
guuerrilla	குற்றில்ல்
guureila	குரேலா
guurilla	கூரில்லால்லா
kaoorilla	கோரில்ல்ல்
kolal	கௌலலல்
kollal	கௌல்லல்கள்
kol	கோல்க
koll	ந்க்ள
kolgiraargal	கொள்கிறார்கள்
kolkiraargal	கொள்கிறார்கள்
kolkiraarkal	கொள்கிறார்கள்
kollavum	கொள்ளவும்
kolladha	கொள்ளதாதாத
kollatha	கொள்ளதாதாத்த்
kollaadhavar	கொள்ளாவவர்
kolladhavar	கொள்ளதாவர்
kollathavar	கொள்ளதாவரர்
kollaadhu	கொள்ளாது
kolladhu	கொள்ளது
kollathu	கொள்ளதுத்து
kollvadhaal	கொள்வதால்ல்
kolvadhaal	கொள்வதால்
kolvathaal	கொள்வதால்
kolukattai	கொழுக்டைட்டை
kolukkattai	கொழுக்கட்டை
kozhukkattai	கொழுக்கத்தை
kolunthu	கொழுந்து
koluntu	ஓழுண்டு
kozhundhu	கொழுந்து
kolupil	கொழுப்பில்
koluppil	கொழுப்பில்
kozhuppil	கொழுப்பில்
colombin	கொலம்பினின்
columbin	கொலும்பின்
columbu	சொழும்பு்
kozhumbin	கொழும்பின்
colombil	சொலம்பில்
columbil	சொழும்பில்
columbu	சொழும்பு்
kozhumbil	கொழும்பில்
gokila	கோகில்ல
koagilaa	கோகிலா
koakila	கோகில்
koatpaatu	கோட்பாட்டுட்டு
kootpaadu	கோட்பாடுடு
kootpaatu	கோட்பாட்டு
koatpaatukalin	கோட்பாட்டுகளின்
kootpaadugalin	கோட்பாடுகளின்
kootpaadukalin	கோட்பாடுகளின்
koatpaatukalum	கோட்பாடுகளும்
kootpaadukalum	ஒட்பாடுகளும்
kootpaatukalum	கோட்பாடுகளும்
koatpaatukalai	கோட்பாடுகளை
kootpaadugalai	கூட்பாடுகளை
kootpaadukalai	கூட்பாடுகளை
kootpaatukalai	கூட்பாட்டுகளை
koatpaatum	கோட்பாட்டும்
kootpaadum	கோட்பாடும்
kootpaatum	கோட்பாட்டும்
gobi	கோபி
gobii	கோபியி
goobi	கோபி
goopee	கோப்பியேகு
goopi	கோபி
goopy	கோப்பிய்க்கு
gopee	கோப்பிர்
gopi	கோபி
gopii	கோபி
gopy	கோப்யிக்க
koabi	கோபிக்கிக்
koapi	கோபிய
kobi	கோபி
kofee	கோப்பியக்குவே
kofi	கோபியக்கி
kofii	கோபியக்
koofee	கூபே
koofi	கோபி
koophee	கூப்ரீ
koophi	கோபி
koopi	கோபிபிப்
kophee	கோபேகு
kophi	கோபி
kophii	கோபியக்கி
qofee	கோபப்பிய்வா
qofi	கோபபிய
qophee	கோபீரி
qophi	கோபி
koappai	கோப்பை
koopai	கோப்பைக்கை
kooppai	கோப்பை
koppai	கோப்பை
koappaigalai	கோப்பைகளை
koopaikalai	கோபைகளை
kooppaigalai	கோப்பைகளை
kooppaikalai	கோப்பைகளை
koppugalai	கோப்புகளை
koappaigal	கோப்பைகள்
koopaikal	கோபைகள்
kooppaigal	கோப்பைகள்
kooppaikal	கோப்பைகள்
koppaigal	கோப்பைகளால்கள்
koappaikkaana	கோப்பைக்கான
koopaikkaana	கோபைக்கான
kooppaikkaana	கோப்பைக்கான
koppaikkaana	கொப்பைக்கான
koappaiyin	கோப்பையின்
kopaiyin	கோப்பையின்
koppaiyin	கோப்பையின்
koappaiyil	கோப்பையில்
kooppaiyil	கோப்பையில்
kopaiyil	கோபேயில்லில்
koppaiyil	கொப்பையில்
koappaiyai	கோப்பையை
koopaiyai	கோபையை
kooppaiyai	கோப்பையை
koppaiyai	கோப்பையை
colie	சாலி
colii	சாலி
colli	கொல்லில்லி
collie	கொல்லி
collii	கொள்ளி
colly	காலி
coly	காலி
coollie	காலி
coollii	காலி
coolly	ல்ல்லி
goalie	க்க
goli	கோலி
golli	கொள்ளி
golly	ல்ல்க்
goly	காலி
gooalie	கோளிளி
goolly	னூல்லி
koali	கோளி
koli	கொளிளி
kolli	கொள்ளி
kolly	நுல்லி
koly	கோல்லக்கு
kooli	கூளி
koolli	ைள்ளி
koolly	லூ்லி
qolli	ைள்ளி
qolly	ால்லி
goliath	காலியத்யத்
golieth	கோளிதததத்
gooliath	கோளியதத்
kooliyat	கோழியடைட்
goalgalai	கோள்களை
goalkalai	கோல்களை
kolgalai	கொள்களை
koolgalai	கோள்களை
koolkalai	கூழ்களை
goldain	லல்டைனைன்
goldan	கொள்டன்
golden	கால்டன்
gooldain	கோல்டைன்
gooldan	கோல்டான்கான்
goolden	கோல்டின்
kooldan	கூல்டான்
kooltan	கூல்டண்டுன்கான்
colt	சொல்ட்்ட்டி
coolt	சுல்ட்ட
cooltt	்ச்ட்சு
cooult	சுல்ட்ச்ச்ட்
coult	ல்ட்ச்ச்ட்சுல்ல
couult	எல்ட்ட்ட்ட்ட்ட்டு
gauld	தல்டு
gauuld	ல்டு
gold	கொல்ட்டுக்
golda	கொல்ட
goold	க்ள்ள
goolda	க்டு
goould	கோல்ட்டு
gould	கால்ட்டு
gouuld	ல்ட்ட்டு
kolt	கோல்ட்டு
koold	ல்டுக்
koolt	கூள்ட
qolt	கல்ட
golf	ப்ளக்
koolp	ப்ளக்
kolin	லோனி
koolin	லூினில்
koovalanum	கோவளனமும்
kovalanum	கோவானும்
koovalan	கோவாலனான்
kovalan	கோவாலன்
cauimbatoore	செய்ப்படூர்றேறே
cauimbatore	சூம்பட்டரூரே
cauimbetore	செய்ம்பெட்டர்
cauuimbatore	சூய்பட்டரூரே
coimbaatore	செய்மாட்டோர்
coimbaetore	செய்மைட்டரூர்
coimbatore	சொய்மைட்டூரேற்
coimbetore	சொய்மைட்டெற்றேறேற்
cooimbaatoore	கோய்பாட்டூர்
cooimbatoore	சிய்பாட்டூரேசேரூரே
covai	சோவை
koimbatore	கோய்ம்பாட்டரூரே
koimbetore	கோய்ம்பெட்டர்
kooimbatoore	கோய்ப்பதூரூரே
koovai	கோவை
kovai	கோவை
qoimbatore	கோய்மாப்டூரேற்றேே
covaiyin	கோயையின்
koovaiyin	கோவையின்
kovaiyin	கோவையின்
covaiyil	சோயையில்
koovaiyil	கூவையில்
kovaiyil	கோவையில்
gaurava	ஞாரவவாவவா
gowrava	கோவாவவாவாவ
kaurava	கௌரவவாவ
gouravikkum	கௌரவிக்கும்
gowravikkum	கோரவிக்கும்
gowrawikkum	கோரவிக்கும்
kouravikkum	கௌரவிக்கும்
cakkarangalai	சக்கரங்களை
cakkarankalai	சக்கரங்களை
chakkarangalai	சக்கரங்களை
chakkarankalai	சக்கரங்களை
sakkarangalai	சக்கரங்களை
sakkaranggalai	சக்கரங்களை
cakkarattin	சக்கரட்டின்
chakkarattin	சக்கராத்தின்
sakkaraththin	சக்கரத்தின்
cakkarattai	சக்கரட்டை
cakkaratthai	சக்கரத்தை
chakkarattai	சக்கறட்டை
chakkaratthai	சக்கற்த்தை
sakkaraththai	சக்கரத்தை
cakkarattaip	சக்கரட்டைப்பை
cakkaratthaip	சக்கரத்தைப்பைப்
chakkaraththaip	சக்கரத்தைப்
chakkarattaip	சக்கரத்தைப்பைப்
chakkaratthaip	சக்கரத்தைப்பைப்
sakkaraththaip	சக்கரத்தைப்
chakravarthi	சக்கிரவர்த்தி
charavarththi	சரவர்த்தி
sakravarththi	சக்ரவத்தி
sangak	சங்கக்காக
sangkak	சங்கக்க
cankangalukku	சங்கங்களுக்கு
cankankalukku	சங்கங்களுக்கு
chankangalukku	சங்கங்களுக்கு
chankankalukku	சங்கங்களுக்கு
sangangalukku	சங்கங்களுக்கு
sangkangkalukku	சங்கங்களுக்கு
cankangalai	சங்கங்களை
cankankalai	சங்கங்களை
chankangalai	சங்கங்களை
chankankalai	சங்கங்களை
sangankalai	சங்கங்களை
sanggangkalai	ஊங்கங்களை
cankangal	கங்கங்கள்
cankankal	கங்கங்கள்
chankangal	சங்கங்கள்கள்
chankankal	சங்கங்கள்
sangankal	சங்கங்கள்
sanggangkal	சங்கங்கள்
cankat	காங்கத்தக்க
cankath	சங்கத்த
chankat	சங்கத்தாக்கட்ட
chankath	சங்கத்தத்
sangath	சங்கத்த
sanggath	சங்கத்தத்
cankattirku	சங்கத்திற்கு
chankatthirku	சங்கத்திற்கு
sangaththirku	சங்கத்திற்கு
sanggaththirku	சங்கத்திற்கு
sangaththil	சங்கத்தில்
sanggaththil	சங்கத்தில்
sangaththai	சங்கத்தை
sanggaththai	சங்கத்தை
sangamathil	சங்கமதித்தில்
sangamaththil	சங்கமத்தில்
sanggamaththil	சங்கமத்தில்
sankamathill	சங்கமதில்ல்
sangamam	சங்கமமம்
sanggamam	சங்கமாமம்
sankamam	சன்கமாமம்
sankamum	சங்கமும்
sangamaaga	சங்கமாக
sangamaaha	சங்கமாக
sangamaga	சங்கமாககாக
sangamaha	சங்கமாகத
sanggamaaga	சங்கமாக
sangamekkum	சங்கமேக்கும்
sangamigum	சங்கமிகும்
sangamikkum	சங்கமிக்கும்
sanggamikkum	சங்கமிக்கும்
sankamikkum	சங்கமிக்கும்
sangamoom	சங்கமூம்
sangamum	சங்கமும்
sanggamum	சங்கமும்
sankamum	சங்கமும்
sangavai	சங்கவை
sangavi	சங்கவி
sangili	சங்கிளி
sangily	சங்கிலியில்
sangkili	சங்கிலிலி
sanggiligal	சங்கிலிகள்
sangiligal	சங்கிலிகள்
sangilikal	சங்கிலிகள்
sanggiliyaal	சங்கிலியால்
sangiliyaal	சங்கிலியால்
sangiliyal	சங்கிலியல்
sanggiliyai	சங்கிலியை
sangiliyai	சங்கிலியை
sangilyyai	சங்கிலையை
cankai	சங்கைை
chankai	சங்கைை
sangai	சங்கை
sattama	சட்டமம்ம
sattamaa	பட்டமாமாமாாம்
sattai	சட்டை
sattaiyin	சட்டையின்
sattaiyil	சட்டையில்லில்
sattaiyai	சட்டையை
sadhaveedhaththil	சதவீதத்தில்
sathaveethaththil	சதவீதத்தில்
sadhaveedham	சதவீதம்
sadhaveetham	சதவீதம்
sathaveetham	சதவீதம்
sadhi	சத்தி
satee	ஸ்தசசத்
sathi	சததி
sati	சத்தசி
satii	ஸ்தி
satti	்கி
setee	தீச்டி
seti	சேதி
setii	சேதி
setti	ேட்டி
satees	சதேசஸஸஸ்ஸ்
sateesh	ஷேஷ்ஷ்
satheesh	சதீஷ்ஷ்
sathis	சிஷிஸ்ஷிஷ்
sathish	சிசிஸ்
satiis	ஸ்டிஷிஸ்
satiish	ஷிஷிஸ்ஷ்
satis	சிஸ்டிஸஸ்ஸ்டிஸ்ஸிஸ்ஸிஸ்ஸிஸ்ஸிஸ்ஸ
satish	டிஷிஸ்ஸ்
setees	சதசசஸ்ஸ்ஸஸ்ஸ்டஸ்ஸ்
setiis	சிசாசிசி
setis	சிசிஸ்ஸ்டிஸ்
sathya	சத்யாயா
sathyaavin	சத்யாவின்
sathyavin	சத்யாவின்
santharppangalil	சந்தரப்பங்களில்
santharppangkalil	சந்தர்ப்பங்களில்
santharppankalil	சந்தர்ப்பங்களில்
santharppangalai	சந்தரப்பங்களை
santharppangkalai	சந்தரப்பங்களை
santharppankalai	சந்தரப்பங்களை
santharppangal	சந்தரப்பங்கள்
santharppangkal	சந்தரப்பங்கள்
santharppankal	சந்தர்ப்பங்கள்
santharppaththil	சந்தரப்பத்தில்
santharppam	சந்தரப்பம்
sandhia	நந்தியாய்
sandhiaa	காண்டியா
sandhiya	சந்தியை
sandhya	பாத்தியா
sandhyaa	சந்தாய்ய
santhaippaduththal	சந்தைப்படுத்தல்
sabari	சபாரி
sabaiyinaal	சபையினால்
chamakaala	சமகாகலால
samakaala	சமகாலால
samanaana	சமானான
samanana	சமநனனன
samapangku	சமபணங்கு
samamaaga	சமமாக
samamaga	சமமாககாக
samamaka	சமமாகககககககககககககககககககககககககககக
samamaagavum	சமமாகவும்
samamagavum	சமமகவும்
samamakavum	சமமககவும்
samayath	சமயததததததததததததத்
samarppiththaar	சமற்பிப்தார்
samarppiththu	சமற்ப்பித்து
samarppiththullaar	சமற்பித்துள்ளார்
samaiththa	சமைத்தாத்த்த்த்த்த்த்த்த்த்த்த்த
samayththa	சமைத்த்த்
saimaiththal	சைமைத்தல்
samaiththal	சமைத்தல்
samayththal	சமைத்தல்
samaiththaal	சமைத்தால்
samayththaal	சமைத்தால்லால்
sam	சமசஷ்மஸ்ம
sum	சும்ஸ்
samsaaram	சமாசாரமமம்
samsaram	சமாஸரம்
sambiradhaaya	சம்பிரதாய்யாயாய்
sambradhaaya	சம்ப்பிரதாயாயை
sambrathaaya	சம்ப்பிரதாயாயா
sampirathaaya	சம்பீரதாய்
sampirathaya	சம்பீரதயையை
samprathaaya	சம்ப்பதாய்யாயை
sambiradhayamaana	சம்பிரதயான
sambirathaayamaana	சம்பிரத்யான்
sambradhayamaana	சம்ப்பிரதாயான
sambrathaayamaana	சம்ப்பிரதாயமான
sampirathaayamaana	சம்பிரதாயமான
sammandhdhar	சம்மந்தர்
sammanthar	சம்மந்தர்
sarakkugal	சரக்குகள்
sarakkukal	சரக்குகள்
saranadaintha	சரணடைந்த
saranadainthathu	சரணதைந்தது
saranadainthaar	சரரணடந்தார்
saranadainthar	சரணடைந்தர்
saranadainthu	சரணடைந்து
curender	குரெண்டர்
currendar	சுற்றண்டர்டரர்
currender	சுர்ந்திர்ர்ர்ர்
cuurrender	சூர்றெண்டர்ர்ர்ர்
saranadaiya	சரரணையாயை
sarendar	சரேந்தர்
sarrendar	சர்ணெண்டரர்
surendar	சுரேந்தரர்
surendarr	சுரேந்தர்
surender	சுர்நார்ட்ர்
surenderr	சுரேந்தர்
surrendar	சுற்றெண்டர்
surrender	சுற்றெண்டர்
suurenderr	சுர்நார்த்ர்
suurrendar	சூர்ந்தரண்டன்
suurrender	சூர்ந்தேர்
sarayu	சரேயு
saralamaaga	சரலாமாக
saralamaaka	சரலமாக
saralamaka	சரலமாகக்
sarala	சராலலாாலாாலா
saravanabavan	சரவனபானவன்
saravanabhavan	சரவனபானவன்
saravanapavan	சரவவனானவன்
saritham	சரிதம்
saritha	சரித்த
roaga	ரோக்கோரோ
roaka	ராக்கோர்க்கப்ப்
roka	ராக்கோகோ
rooka	ரூக்கோகோக்கூகககோ
sarva	சர்வ
sarvam	சர்வம்மம்மம்ம்ம்மம்ம்
sarvarukku	சர்வருக்கு
servarukku	சேர்வறுக்கு
serverukku	சேர்வேறுக்கு
sarvar	சர்வரர்
sarvur	சர்வூர்
sarwar	சர்வரர்
servar	சேர்வரர்
server	சேர்வர்
servur	செர்வுரூர்
servuur	ர்வூர்ர்
serwar	சேர்வரர்
serwer	சர்வேர்
serwur	செர்வர்
survar	சுவ்வரர்
surver	சுவ்வர்
surwer	சுவ்ர்
suurver	சூர்வர்
sarvargal	சர்வர்கள்
sarvarkal	சர்வர்கள்
servergal	சேர்வேர்கள்
serverkal	சேர்வேற்கள்
satruth	சுற்றுத்துத்துத்துத்துத்
sattruth	சுற்றுதுத்து
satrup	சுற்றுப்புப்புப்
sattrup	ன்றுப்புப்புப்புப்புப்புப்புப்பு
satrum	சற்றும்ம்
sattrum	சற்றும்
satre	சுர்ரேரேஷ்ரி
sattrae	தற்றேரே
sattre	தற்றேரேஷ்
saasana	சாசனானனான
sasana	சசன்னமான
saasanangal	சாசநங்கள்
saasanankal	சாசநங்கள்
sasanangal	சசநங்கள்
sasanankal	சசநங்கள்
saasanaththin	சாசநத்தின்
sasanaththin	சசனத்தின்
saasanaththil	சாசநத்தில்
sasanaththil	சசநாத்தில்
saanjchi	சாஞ்சி
saanji	ஞ்சி
sanchi	சன்சிசி
sanji	சஞ்சி
saandoa	நாந்தோ
sando	ந்தோன்
santo	ந்தன்
saadhagam	சாதகமம்
saathakam	சாதகமமம்
sathakam	சதககம்
saadhaaranamaana	சாதாரணமான
saathaaranamaana	சாதாரணமான
saaththiyamaa	சாத்தியமாம்
chaantha	சாந்த
kumaari	குமாறி
kumari	குமாரி
saantha	நாந்தாந்த்்த
saanthan	சாந்தன்
santhan	சந்தன்நான்ன்ன்ன்ன்ன்ன்ன்ன்ன்ன்ன்
saanthappaduththum	சாந்தப்படுத்தும்
saanthappaduthum	சாந்தப்படுத்தும்
saantham	சாந்தம்
santham	சந்தமம்
sanththam	சந்தம்ம்ம்
saamaaniya	சாமானியாய
caaminaathan	சாமினாதன்
chaaminaathan	சீமினாதன்
saaminaadhan	சாமினாதன்
saaminaathan	சாமினாதன்
saaradhigal	சாரதிகள்
saarathigal	சாரதிகள்
saarathikal	சாரதிகள்
saradhigal	சரரதிகள்
sarathigal	சரதிகள்
sarathikal	சரத்திகள்
chaallukiyar	சாலுகியரியர்
chalukkiyar	சலுக்கியர்
chalukyar	சலுக்கியர்
saallukiyar	சால்குகியர்
saalukkiyar	சாலுக்கியர்
sallukiyar	சழ்லுகியர்
chalukiyargal	சலுக்கியர்கள்
chalukkiyarkal	சலுக்கியர்கள்
chalukyargal	சலுக்கியர்கள்
saalukkiyargal	சாலுக்கியர்கள்
saalukkiyarkal	சாலுக்கியர்கள்
salukkiyarkal	சலுக்கியர்கள்
kei	
key	டெய்க்்
qey	கெய்க்
saavi	விவி
saavithri	சாவித்ரி
savithri	சவித்திரி
savitri	சவவித்ரி
saashthiri	சாஸ்திரி
saasthiri	சாஸ்திரிரி
sasthri	ச்்சிரி
sastree	ச்சீரி
sastri	ச்்சிரி
sastrii	ச்சிசி
sastrree	சஸ்ட்ரீ
sastrrii	சர்ஸ்ரி
shastree	சொஸ்றேரீ
shastri	சஷ்டிரி
shastrree	ஷெஸ்டிர்ஸ்வீரீ
saashthirigal	சாஸ்திரிகள்
saasthirigal	சாஸ்டிரிகள்
sasthirigal	சாஸ்திரிகளில்
shashthrigal	சஷ்திரிகள்
chikkana	சீக்கனன
sikana	கேசனான
sikkana	சிக்கணன
chikkanamaaka	சிக்கநமாக
sikanamaka	சிகானமாககாக
sikkanamaaga	சிக்கநமாகாக
sikkanamaaka	சிக்கநமாக
chikkanamaana	சிக்கநமான
sikanamana	சிகாமணமான
sikkanamaana	சிக்கணமானனான
chittu	சிட்டுக்குச்சுச்
seetu	சீட்டு
seetuu	சீட்டு
siitu	சீத்துரசு
sito	சித்தோஸ்டோச்சுஸ்டோரோஸ்டோரோச்ட்சோ
sitoo	தித்தோஸ்டூ
sittu	சிட்டுச்
situ	சிட
situu	தூட
chittuk	கிட்டுக்க
sittuk	சீத்துக்குக்குக்
seeddharth	சீத்தர்த்த
seedharth	சீதர்தர்த்த
seidharth	செய்தார்த்த
seydharth	செய்தர்த்த
siddharth	சித்தர்த்தர்த
sidharth	சிதர்தர்தர்த
sidharthh	சிதர்தர்த்த
siiddharth	சீத்தர்தர்
siththaarth	சித்தார்த்த்
sittharth	சித்தர்தர்த
chithirai	சித்திரை
sithirai	சித்திரை
siththirai	சித்திரை
sitthirai	சித்திரை
chithiraip	சித்திரைப்பைப்பைை
sithiraip	சித்திரைப்பைப்பை
siththiraip	சித்திரைப்பைை
sitthiraip	சித்திரைப்பைைப்
chinthitthal	சிந்தித்தல்
sinthithal	சிந்திதழ்தல்
sinthiththal	சிந்தித்தல்
sinthitthal	சிந்தித்தல்
caardu	சார்டு
card	சர்ட்ச்ட்ச்ட்்ட்்ட்ச்ட்க்ட்்ட்க்
kaardu	கார்டு
kartu	கற்டுக்கு்
sim	ாசஸ்ஸிஸ்
shimman	சிம்மான்ணன்
simman	சிம்மாமண்ணன்
simmon	சிம்மன்
chims	னிச்சிஸ்ஸ்
semms	சமமஸ்ம்ஸ்ம்
sems	ச்ச்ச்ஸ்ஸ்ஸ்ஸ்ஸ்ம்ம்ஸ்ம்ஸ்ம்ஸ்ம்
siims	ச்சாம்ஸ்
simms	மிஷ்ம்ஸ்ம்
sims	ச்சாம்ஸ்
simss	ச்ஸ்ஸ்ஸ்ஸ்ஸ்ஸ்ஸ்ஸ்ஸ்ஸ்ஸ்ஸ்ஸ்ஸ்ஸ்
symms	ச்சிஸ்ஸ்
syms	ச்ச்ச்ஸ்ஸ்ஸ்ஸ்ஸ்ஸ்ஸ்ஸ்ஸ்ஸ்ஸ்ஸ்ஸ்
siraaj	ாஜாஜாஜாஜாஜாஜ்ஜாராஜாஜாஜாஜாஜாஜ்ஜார
siraj	சிறாஜ்ரசஜ்ரஜாராஜ்ரஜாரஜார்ஜ்ராஜ்ஜ
sirian	சிரியன்
syrian	சிரியன்
syriyan	சீரியன்
siriap	ஸிரியாபப்பப்பிபப்பிபப்பிபப்பிபப்
siriyap	சிறியப்பப்பப்பப்பப்
syriap	ஷிபப்ப்பப்ப்ப்ப்ப்பாரப்ப்பப்ப்பப
syriyap	சிறியப்பப்பபப்பப்
siridhalavu	சிறிதாவவு
siridhazhavu	சிறிதழவவு
sirithalavu	சிறிதளவு
siridhu	சிறிது
sirithu	சிறிதுத்யு
siridhum	சிறிதும்
sirithum	சிறிதும்ம்
seelica	சீலிச்சாச்சிச்
siilica	ஸிலிசிக்சாச்சிச்
silica	சீசிகா
silicca	ஸிலிக்ச்ச்ச்ச்ச்ச்ச்ச்ச்ச்ச்ச்ச்
silika	சிலிகா
siliqa	ஸி
silicon	சிலிச்சன்
silikkaan	சிலிக்கான்னான்
silikon	ஸிலிகான்னன்
shiiv	சிவசஸ்வே
shiv	சஷ்வஸ்
shiva	சிவிவ்வ
siiv	சிவசசஸ்
siiw	சிவசஸ்வு
siv	ைச்சசஸ்
siva	சிவாஸ்
siw	விசஸ்விவ்விவ்வி
siwa	சசஷஸ்விஸ்வோவ்வி
sivandhu	சிவந்து
sivanthu	சிவந்து
sivanin	சிவணினின்
sivanukku	சிவனுக்கு
sivaperumaanae	சிவபெருமானே
sivaperumane	சிவபெருமானேன்
sivappiragasa	சிவப்பிராசசசசசசசசசசசசசசசசசசசசசசச
sivappirakaasa	சிவப்பிரகாசாச
sivappirakasa	சிவப்பிரகசாசாச்ச
sivapragasha	சிவப்ராஷாசசசஸ்
sivaprakasa	சிவப்பிகா
sivam	சிவாம்மம்ம்மம்மாம்
secret	சேச்செட்
seekraet	சீக்ரேட்ட்டிட்ட்ட்ட்ட்ட்ட்ட்ட்ட்
seedhakkadhi	சீதக்கதி
seedhakkathi	ஈதக்கதி
seethakathi	சீதகத்திி
seethakkaathi	சீதக்காதி
seethakkadhi	சீதக்கதிததி
seethakkathi	ஈதக்கதி
seenivasa	சீனிவாசம்சாசரசச
srinivasa	ர்ரீனிவசசசச்
chiirutai	சீருடை
chirutai	சிறுத்தை
seerudai	சீருடை
serutai	செருடை
siirutai	சீருடைடை
cheerutaikal	சீருடைகள்
seerudaigal	சீருடைகள்
seerudaikal	சீருடைகள்
chiirutaip	சீருடைப்பை
chirutaip	சிறுத்தைப்பைப்
seerudaip	சீருடைப்
serutaip	சரருடைப்பைப்
siirutaip	சீருடைப்பைப்
seelam	சீலமம்
seelaa	லேசாலிலா
sheela	சேலஸ்லி
chukku	சிக்குகுகுகுகுகுகுழு
sukku	சுக்கு
chudalai	சுடலைை
sudalai	சுடலை
chutalaimaatan	சுடலைமாடன்
sudalaimaadan	சுடலைமாடன்
sudalaimadan	சுடலைமான்
sudalaimatan	சுடலைமான்்
sutalaimaatan	சுடலைமாடன்
chutthappadutthum	சுத்தப்படுத்தும்
sudhthappaduththum	சுத்தப்படுத்தும்
suthapaduthum	சுதப்படுத்தும்
suththappaduththum	சுத்தப்படுத்தும்
sutthappadutthum	சுத்தப்படுத்தும்
chuthamaana	சுதமானான
suthamaana	சுதமான
suthamana	சுதமணமான
suththamaana	சுத்தமான
sundari	சுந்தரி
sundhari	சுந்தரி
sunthari	சுந்தரி
suba	ேசுசபா
subaa	ுசாசா
subha	ுசோசுசபு
suraakkal	சுராக்கள்
chutrtrivara	சுற்றுற்றதர்
surrivara	சுற்றிவரை
sutrivara	சுற்றிவரராடரரரரரரர்
sutrtrivara	சுற்றிவரர்
suttrivara	சுற்றிவராதர
surrullaa	சுற்றுள்ளா
sutrullaa	சுற்றுள்ளா
suttrulaa	சுற்றுழாளாள்ளா
payanigalai	பயணிகளை
payanikalai	பயணிகளை
payanikalaip	பயணிகளைப்பை
surrullaap	சுற்றுள்லாப்பாப்
sutrullaap	சுற்றுள்லாப்பால்
suttrulaap	சுற்றுழாபாபாலாபாப்பாளாபாபாபாபாலா
chuvarin	சுவரினி
suvarin	சுவரினி
chuvarkal	சுவர்கள்
suvargal	சுவர்கள்
suvarkal	சுவர்கள்
suvaasikka	சுவாசிக்க
suvachikka	சுவசிக்க
suvasikka	சுவசிக்க
suvaasikkum	சுவாசிக்கும்
suvachikkum	சுவசிக்கும்
suvasikkkum	சுவசிக்கும்
choottik	கோட்டிக்கிக்கி
chuttik	குட்டிக்கிக்கு
shoottik	ஷோட்டிக்கி
soottik	சோட்டிக்கி
choottinaar	சூட்டினார்
chuttinar	சுட்டினரர்
shoottinaar	சூட்டினார்
soottinaar	சூட்டினார்
soottinar	சூட்டினர்
choothaattam	சூதாட்டம்டம்
soodhaattam	சூதாட்டம்டம்
soothaattam	சூதாட்டம்டம்
sooraavaligal	சூராவளிகள்
sooraavalikal	சூராவளிகள்
sooravazhigal	சூரவழிகள்
sooraavaliyil	சூராவலியில்
sooravaliyil	சூரவழியில்
suravaliyil	சுரவலியில்
suravazhiyil	சுரவழியில்
soolappattadhu	சூழப்பட்டது
soolappattathu	சூழப்பட்டது
soozhappattadhu	சூழப்பட்டது
soozhappattathu	சூழப்பட்டது
soolappattullathu	சூழப்பட்டுள்ளது
soozhappattullathu	சூழப்பட்டுள்ளது
suzhappattullathu	சுழப்பட்டுள்ளது
sengkuththaana	செங்குத்தான
sengkutthaana	செங்குத்தான
senguththaana	செங்குத்தான
senkuththaana	செங்குத்தான
chengai	செங்கைை
sengai	செங்கைணை
chenchi	செஞ்சி
gingee	க்கீ
senchi	சேஞ்சி
senjchi	சஞ்சிஸ்
senji	சஞ்சி
centar	காந்தர்
center	செந்தர்
centre	சந்திர்
saentar	சந்தர்ர்
sentar	ந்்தர்
centi	ந்தி
senti	ந்தி
caent	ண்ட்க்கெக்ட்்
cent	கந்த
scent	ந்த
send	ந்த
sent	ந்த
jeppelin	ஜெய்பெலினினினினினி
zepelin	ஜெபெலினினின்
zeppelin	ஜெப்பிலினினின்
seyarpaadu	செயற்பாடு
seyarpadu	செயற்படு
seyarpaadugalin	செயற்பாடுகளின்
seyarpaadugalilum	செயற்பாடுகளிலும்
seyarpadugalilum	செயற்படுகளிலும்
seyarpaadugalil	செயற்பாடுகளில்
seyarpaadugalukkaana	செயற்பாடுகளுக்கான
seyarpaadugalukku	செயற்பாடுகளுக்கு
seyarpaadugalum	செயற்பாடுகளும்
seyarpadugalum	செயற்படுகளும்
seyarpaadugalai	செயற்பாடுகளை
seyarpaadugalaik	செயற்பாடுகளைக்
seyarpadugalaik	செயற்படுகளைக்
seyarpaadugalaiyum	செயற்பாடுகளையும்
seyarpadugalaiyum	செயற்படுகளையும்
seyalaatra	செயலாறாற்ற
seyalaattra	செயலாற்ற
seyalatra	செயலற்றன்ர
seyalilandhdhu	செயலிலாந்து
seyalilanthu	செயலிலன்து
seyalizhandhdhu	செயலிழந்து
seyalizhandhu	செயலிழந்து
seyalizhandu	செயலிழண்டு
seyalukkaaga	செயலுக்காக
seyalukkaga	செயலுக்ககககககக்
seyalpadaatha	செயல்படாத்தாட்ட
seyalpadadha	செயல்படத்ததாட
seyalpadatha	செயல்படத்தத்த
seyalpatatha	செயல்படத்த
seyalpadudhal	செயல்படுதலுதல்
seyalpaduthal	செயல்படுத்தல்
cheyalpadum	செயல்படுமும்
seyalpadum	செயல்படும்ம்
seyalpatum	செயல்படும்மும்
cheyalpatumpoothu	செயல்படும்போது
cheyalpatumpothu	செயல்படும்போது
seyalpadumpoathu	செயல்படும்போது
seyalpadumpodhu	செயல்படும்போது
seyalpadumpothu	செயல்படும்போது
seyalpatumpoothu	செயல்படும்போது
cheyalpaduvathu	செயல்படுவது
seyalpaduvadhu	செயல்படுவது
seyalpaduvathu	செயல்படுவது
seyalpatuvathu	செயல்படுவது
cheyalmuraikalai	செயல்லுறைகளை
seyalmuraigalai	செயல்முறைகளை
seyalmuraikalai	செயல்முறைகளை
cheyalmuraikal	செயல்லுறைகள்
seyalmuraigal	செயல்முறைகள்
seyalmuraikal	செயல்முறைகள்
cheyalmuraikku	செயல்லுறைக்கு
cheyalmuraiku	செயல்லுறைக்கு
seyalmuraikku	செயல்முறைக்கு
cheyalmuraiyil	செல்மெருரையில்
seyalmuraiyil	செயல்முறையில்
cheyalmuraiyai	செயல்முறையையை
seyalmuraiyai	செயல்முறையை
cheyint	செய்ந்த்த்த்த்த்த்த்த
saent	ந்தைஸ்்
saint	சைந்த
saintt	சைந்திஸ்்
seint	ந்த
sent	ந்த
sentt	ந்த
seyint	நேிந்த்த்த்த்த்த்த்த்த்த்த்த்த்த
chain	சைனச்சைக்சைச்சைச்ச்
chayn	சைனை
chein	சினைச்சைச்
cheinn	சைன்சனைச்சிசி
chen	சன்சிச்சை
cheyin	சொனினின்
cheyn	காய்னிச்சைச்
cheynn	சைன்
seyin	ுசினிய
seithathin	செய்தத்தின்
cheythamaiyaal	செய்தமையால்
cheythamaiyal	செய்தமையல்
seidhamaiyaal	செய்தமையால்
seithamaiaal	செய்தமையால்
seithamaiyaal	செய்தமையால்
seythamaiyaal	செய்தமையால்
cheythavarukku	செய்தவருக்கு
cheythavaruku	செய்தவருக்கு
seidhavarukku	செய்தவருக்கு
seithavarukku	செய்தவருக்கு
seythavarukku	செய்தவருக்கு
seidhullaargal	செய்துள்ளார்கள்
seithullaargal	செய்துள்ளார்கள்
seithullaarkal	செய்துள்ளார்கள்
seibavar	செய்பவர்
shipper	சிப்பெற்
siper	சிப்பர்
sippar	சிப்பார்
sipper	சிப்பர்
seibavargalae	செய்பவர்களே
seibavargale	செப்பவர்களே
seibavarkale	செய்பவர்களே
seibavargal	செய்பவர்கள்
seibavarkal	செய்பவர்கள்
seimadhi	செய்மதி
seimathi	செய்மதி
seiyappatta	செய்யப்பட்ட
seiyyappatta	செய்யப்பட்ட
seiyappattathaaga	செய்யப்பட்டதாக
seiyappattathaaka	செய்யப்பட்டதாக
seiyyappattadhaaga	செய்யப்பட்டதாக
seiyyappattathaaka	செய்யப்பட்டதாக
seiyappattathu	செய்யப்பட்டது
seiyyappattadhu	செய்யப்பட்டது
seiyyappattathu	செய்யப்பட்டது
seiyappattathum	செய்யப்பட்டதும்
seiyyappattadhum	செய்யப்பட்டதும்
seiyyappattathum	செய்யப்பட்டதும்
seiyappattanar	செய்யப்பட்டனர்
seiyyappattanar	செய்யப்பட்டனர்
seiyappattapoothu	செய்யப்பட்டபோது
seiyappattapothu	செய்யப்பட்டபோது
seiyyappattapodhu	செய்யப்பட்டபோது
seiyyappattapothu	செய்யப்பட்டைத்த
seiyappattavudan	செய்யப்பட்டவு
seiyyappattavudan	செய்யப்பட்டவுடன்
seiyappattavai	செய்யப்படைவவை
seyyappattavai	செய்யப்பட்டவை
seiyappattaan	செய்யப்பட்டான்
seiyappattan	செய்யப்பட்டன்
seyyappattan	செய்யப்பட்டன்
seiyappattaar	செய்யப்பட்டார்
seiyappattar	செய்யப்பட்டற்
seyyappattar	செய்யப்பட்டார்
seiyappattaalum	செய்யப்பட்டாலும்
seiyappattalum	செய்யப்பட்டலும்
seyyappattalum	செய்யப்பட்டுள்மு
seiyappattirundha	செய்யப்பட்டிருந்த
seiyappattiruntha	செய்யப்பட்டிருந்த
seyyappattiruntha	செய்யப்பட்டிருந்த
cheyyappattu	செய்யப்பட்டு
seiyappattu	செய்யப்பட்டு
seiyyappattu	செய்யப்பட்டு
seyyappattu	செய்யப்பட்டு
seiyappattullaar	செய்யப்பட்டுள்ளார்
seiyappattullar	செய்யப்பட்டுள்ளரள்
seyyappattullar	செய்யப்பட்டுள்ளார்
seiyul	செய்யுல்
seyyul	செய்யுலுல்
seiyulgal	செய்யுல்கள்
seyyulgal	செய்யுல்கள்
seyyulkal	செய்யுல்கள்
cherbiya	சேர்பியாய்ய
cherbiyaa	சேர்பியாயா
sarbbiis	சர்ப்சிசிசிச்
sarbia	சர்பியா
sarbiya	சர்பியாயி
serbbiis	சர்பிசிசிசிசிசிசிசி
serbia	பார்பியா
serbiia	ஊர்பியாய்யை
serbiis	சர்பிசிசிஸ்
serbiya	சர்பியாயைய்ய
serbiyaa	சர்பியா
cherinthu	செறிந்து
serindhu	சேரிந்து
serinthu	செரிந்து
chelavidum	செலவிடும்
selavidum	செலவிடும்
cheluthinar	செலுத்தினர்
chelutthinar	செலுத்தினர்
seluthinar	செலுத்தினர்
seluththinar	செலுத்தினர்
selutthinar	செலுத்தினர்
sevvaai	சேவ்வாய்
sevvaaik	செவ்வாய்க்
segariththu	சேகரித்து
sekariththu	சேகரித்து
segarippadhil	சேகரிப்பதில்
sekarippathil	சேகரிப்பதில்
segarippadhu	சேகரிப்பது
sekarippathu	சேகரிப்பது
segarippu	சேகரிப்புப்பு
sekarippu	சேகரிப்பு
segaripputh	சேகரிப்புத்துத்
sekaripputh	சேகரிப்புத்து
chaethamadainththa	சேதமடைந்த்
saethamadainththa	சேதமடைந்த
sedhamadaindha	சேதமடைந்த
sethamadaindha	சேதமடைந்த
chaethamadainththu	சேதமடைந்து
saethamadainththu	சேதமடைந்து
sedhamadaindhu	சேதமடைந்து
sethamadaindhathu	சேதமடைந்தது
chaethamadainththana	சேதமடைந்தன
saethamadainththana	சேதமடைந்தன
sedhamadaindhana	சேதமடைந்தன
sethamadaindhana	சேதமடைந்தன
saei	்சிசஸ்
saey	சேசசஸ்
sei	
sey	யசஸ்சையேச்செய்யைசி
cheralaathan	சேரலாதனனதன்
saeralaathan	சேரலாதனதன்
saeralathan	சேரலததான்தன்
seralathan	சேரலததனான்்ன்
chairil	ிலி
saeril	ேசிலிலில்
saerkkai	சேர்க்கை
serkkai	சேர்க்கை
saerkkaigal	சேர்க்கைகள்
serkkaikal	சேர்க்கைகள்
saerkkaiyaal	சேர்க்கையால்
serkkaiaal	சேர்க்கையால்
serkkaiyaal	சேர்க்கையால்
saerkkaiyin	சேர்க்கையின்
serkkaiin	சேர்க்கைநின்
serkkaiyin	சேர்க்கையின்
saertkkiyai	செர்க்கியை
serkaiai	ஊசர்கையை
serkkaiyai	சேர்க்கையை
saerththuch	ஈஸ்துச்சுச்சுச்சுச்சுச்சு
serththuch	ச்சுச்சுச்சுச்சுச்சு
saerththum	சேர்த்தும்
serththum	சேர்த்தும்
saernthu	சேர்ந்து
serndhu	சேர்ந்து
sernthu	சேர்ந்து
saigai	சைகை
syigyi	சீக்சி
saigaigal	சைகைகள்
saigaikal	சைகைகள்
saikaigal	சைகைகள்
saikaikal	சைகைகள்
cybe	சிப்பேசப்பே்சுசீசி
cype	கப்பிப்புப்புப்பிப்புப்புப்புப்ப
saip	ாசாஸ்ஸிஸ்
sybe	சசிஸ்
sype	சபபிச்ச்சிஸ்
saaiman	சாய்மனன்
seiman	செய்மந்மனனனனன்
simon	சிமோனான்
symon	சிமோன்
sailaja	சாலாஜாசாசாலாாாாா
sailajaa	சைலாஜாாாஜாா
shailaja	சைலாஜாசாசாாாாள்ாாாாாாாா
cittanta	சிட்டண்டாண்டன்
siththaantha	சித்தாந்தாந்தாந்த
siththandha	சித்தந்தன்
saivak	ைவககக
saivath	சைவத்த
pirakaasa	உதகாசாசாசாச
pirakaca	பிரகச்ச
saivam	சைவம்மம்மம்ம்மம்ம்ம்
saivargal	சைவர்கள்
saivarkal	சைவர்கள்
sothai	சோதை
soththai	சொத்தை
sonthamaa	ஏந்தமாாமா
chollukkaana	சொல்லுக்கான
cholukana	கொலுக்கான
sollukkaana	சொல்லுக்கான
chollukku	சொல்லுக்கு
choluku	சொலுக்குக்குக்குக்
sollukku	ஊழ்ளுக்கு
chollunkal	சொல்லுங்கள்
cholunkal	சொழுங்கள்
sollungkal	சொல்லுங்கள்
sollunkal	சொல்லுங்கள்
cholludan	சொல்லுடன்
chollutan	சொல்லுடன்
choludan	சொலுடுடன்
solludan	சொல்லுடன்
solvadhaga	சொல்வதாக
solvathaaga	சொல்வதாக
solvathaaka	சொல்வதாக
solvathaga	சொல்வதாகக
cholvathu	சொல்வது
solvadhu	சொல்வது
solvathu	சொல்வது
solvavathu	சொல்வவது
cholvathenraal	சொல்வதேன்றால்
solvadhenral	சொல்வதேன்றல்
solvathenraal	சொல்வதேன்றால்
solvathenral	சொல்வதேன்றன்
solvathentraal	சொல்வதேன்றால்
cholvathai	சொல்வதை
solvadhai	சொல்வதை
solvathai	சொல்வதை
soasalisa	சோசலிசிசிஸ்
socialisa	சிலிசிச்ச
sosalisa	சோஸிலசிச்
choathikkum	சோதிக்கும்
soathikkum	சோதிக்கும்
sothikkum	சொதிக்கும்
choazhapuram	சோழபூரம்
cholapuram	சொல்லப்பிரம்
chozhapuram	சொழப்புறம்
soazhapuram	சோழபுரம்
solapuram	சோழப்புரம்
sozhapuram	சோழபுரம்
choazhar	சோழரர்
cholar	சொலாராார்
chozhar	சொழர்
soazhar	சோழரர்
sozhar	சோழர்
choazharkalin	சோழர்களின்
cholarkalin	கொலர்களின்
chozhargalin	சோழர்களின்
soazharkalin	சோழற்களின்
solarkalin	சோழற்களின்
sozharkalin	சோழற்களின்
choazharkalukku	சோழர்களுக்கு
chozhargalukku	சொழர்களுக்கு
soazhargalukku	சோழர்களுக்கு
soazharkalukku	சோழர்களுக்கு
solarkalukku	சொலர்களுக்கு
sozharkalukku	சோழர்களுக்கு
choazharkal	சோழற்கள்
cholargal	சொலர்களால்கள்
chozhargal	சொழர்கள்
soazhargal	சோழற்கள்
soazharkal	சோழற்கள்
solarkal	சொலர்கள்
sozharkal	சோழற்கள்
choudhri	சோத்ரி
chowdhri	சோத்ரிரி
chowdhry	சௌவிரி
chowthri	சௌத்ரி
southri	சோத்ரி
japanin	ஜா்பனினினினினின்
jappaanin	ஜப்பானினின்
japanai	ஜேனைனை
jappaanai	ஜப்பானை
jaapaan	ஜாபானானான்
jaapan	நாபன்னனனன்
japaan	ஜரானானான்னான்னான்னான்னான்னான்னான
japan	ஜேனனனன்
jappaan	ஜப்பான்னான்
jappan	ஜப்பான்்
zaapaan	ஜாபானானானானானானானானானானானானானானா
zaapan	ஜாபனனன்னன்
zapaan	ஜபானானானானானானானானானானானானானானான
zapan	னணன்னனனனனனனனனனனனனனனனனனனனனனனனனனனன
jappaar	ஜப்பாரார்
jaadhav	வழாவாவ்வு
jaathav	வாவவகவகவாவாவாவாவவாசவாாவவாவாவாவாவ
jadav	சாதவவவாவாவாவவவவாவாவவவாவாி
jaanukku	ஞானுக்கு
jhonukku	ஞ்சுக்கு
johnukku	ஜஹனுக்கு
jaaliyan	ஜாலியன்னியன்
jaliyan	ஜலல்யன்
jallian	ஜாலியன்னியன்
jolyan	ஜாலியன்
jeeva	ஜஜ்ஜே
nathi	நாத
nati	நட்
jeevaathmaa	ஜீவாத்மாம்மா
jeevathma	ஜீவத்ம்ம்ம்ம்ம்
jaed	ிஜ்ஜ்ஜ்ஜ்ஜ்
jaet	தசுஜ்ஜ்ஜ்
jait	ஜேட்
jed	சிடே
jet	சுஜத்ஜஜஜ்ஜ்
jett	த்டெட்ஸ்
zaet	யிட்
zait	ைய்
zed	டசிசே
zet	சுத்தேட்டி
zett	பெட்ட்ட்ட்ட்ட்ட்ட்ட்ட்ட்ட்ட்ட்ட்
gen	கின்ன்
jaen	ஜஜ்ஜ்ன்
jain	சி
jayn	ஜஜ்ஜ்ஜ்ஜாஜ்ஜ்ஜ்ஜ்ஜ்ஜ்ஜ்ஜ்ஜ்ஜ்ஜ்ஜ
jeen	சீன்சி
jen	சேனி
jenn	ஜீன்ன்ன்என்
zain	ைனை
zayn	சன்னின்
zeen	ஜேனின்
zen	ஜெனினின்
zenn	ஞன்னன்னனன்னனன்னனன்னனன்னனன்னனன்னன
jaennr	சேன்ன்ரான்ன்ரன்ன்ன்ன்ன்ன்ன்ன்ன்ன
jener	ஜீனர்
jennar	சென்னர்ன்
jenner	ஜீன்ரர்
zenner	ஜென்னர்்
jane	ஜேனேன்
jean	சியே
jen	சேனி
joordan	ஜுர்டான்
jordaan	ஜர்டான்ன்
jordan	ஜர்டன்
jorddan	ஜர்டாண்டன்
jurdan	ஜர்டன்
zoorann	ஞரன்னன்
zoordan	ஜூரண்டன்
zoorddan	ஜூர்தானண்டன்
zordan	ஜர்டனன்ன்்
zorddan	ஜர்டானண்டன்
joarthaan	ஜோர்த்னான்
jordan	ஜர்டன்
jorthaan	ஜர்தான்
touff	ப்பா
tough	வுக்
daglas	ட்சஸஸ்சாஸ்
daklas	ட்சஸ்சஸ்ாஸ்கஸ்சஸ்ாஸ்கஸ்ாஸ்ாஸ்கஸ்
daklus	டக்லஸ்
douglas	ூக்ஸ்கஸ்சாஸ்ஸ்
douglass	டொக்சலாஸ்ஸ்ஸ்ஸ்ஸ்ஸ்ஸ்ஸ்ஸ்ஸ்ஸ்ஸ்ஸ
douuglas	டோக்சஸ்லஸ்சஸ்
douuglass	டுக்ளசஸ்ஸ்ஸ்ஸ்ஸஸ்ஸ்ஸ்ஸ்ஸ்ஸஸ்ஸ்ஸ்
duglas	ட்சஸ்சசஸ்க
duglus	டுஸ்லஸ்
duuglas	டுஸ்கசஸ்
duugluus	டுஸ்லுசஸ்
taklas	ந்தசஸ்சாஸ்காஸ்காஸ்
taklash	டகலாஷாஷ்ஸஸ்்காஷ்ஷ்ஷ்ஷ்ஷ்ஷ்ஷ்ஷ்ஷ்
taklus	டக்ளுசஸ்
darpoo	டற்போப்பூர்வு
tarbo	ட்போர்ப்ப்்ப்்பர்ப்ப்்ப்்பர்ப்பு
tarboo	டர்போரூ
turbau	துர்பு
turbo	டுர்போர்ப்போ்டோ
turboo	டு்போர்போ
tuurbauu	த்தூர்வு
tuurbo	த்்ப்ப்ப்ப்டோர்
daadaa	தாடா
taata	டாட்டுட்டாட்ட
taataa	டாடா
taeta	டடட
taetaa	தேடாட்டாட்டாட்டாட்டாட்டாட்டாட்டா
tata	டட
tataa	தடாடடட
teta	டசிட்டுட்டேட்டியட்ஏட்ட்ட்ட்டேட்ட
tetaa	ட்ட
dance	்சக்ஸ்கென்ஸ்கைன்ஸ்க்்
dans	ட்ச்ச்ச்ச்ச்ச்ச்ச்ச்ச்ச்ச்ச்ச்ச்
taans	ாஸ்டாஸ்ஸ்ச்ச்ச்ச்சியூட்ஸ்ட
tains	்ச்சென்சின்ஸ்ஸ்ன்ஸ்னின்ஸ்ன்ஷ்
tans	்ச்சென்ஸ்ஸ்ஸ்ஸ்ஸ்ஸ்ஸ்ஸ்ஸ்ஸ்ஸ்ஸ்ஸ
tens	ட்செட்சென்ட்சின்ஸ்்
torch	ச்ச்சை
daarvin	தார்வினின்
daarwin	ைவருவின்
darvin	ைக்சின்
darvinn	டிர்வின்ந்நன்
darvyn	செ்வின்
darwin	வுவின்வின்
darwinn	வருவின்ந்நின்ண்நண்ணன்
darwyn	விி
taarvin	தார்வின்
doon	டோன்னான்
dun	டுன்னுன்னுனுன்ன
duun	டுனு
toon	டோன்ன்டூடன்
toonn	்போன்
toun	ன்னோ
touun	க்
tun	நத்
tunn	ந்ந்ன்னன்ஏன்னன்ஏன்னன்ஏன்னன்னன்னன
tuun	டுன்
decsaas	டக்சாஸசாஸ்ஸஸ்ஸ்ஸஸ்ஸ்ஸ்ஸஸ்ஸ்ஸ்ஸஸ்
teksaas	டிக்சாஸ்ஸாசாஸஸ்ஸ்
texas	சகஸ்ஸ்கஸ்கஸ்கஸ்கஸ்கஸ்கஸ்ஸ்கஸ்
daeevid	விடிடிடிடி
daevid	விடிடிடி
daewid	ீவிடி
david	ைவிடட்
davidd	டிட்ட்ட்ட்ட்ட்ட்ட்ட்ட்ட்ட்ட்ட்ட்
dawid	டீதிடிடிடிடிடிடிடிடிடிடிடிடிடிடி
dawidd	திவிட்ட்ட்டு
deevid	விடி
devid	விடிடிடி
dewid	புவிட்டிட்
tevid	ட்டிடிடிடிடிடிடி
davidson	தைவிஸ்டன்
dawidson	தேமிட்சன்
tevitsan	தெவிட்சன்
daai	ஈத்தாய்
daaii	டி
dae	ஈஸ்
dai	டை
daie	டே
daiie	தேய்
dee	டே
die	ௌதி
diie	திய
dye	டிய்யி
taai	ட்டடடடடடடடட
tae	டஏட்ட்ட்ட
tai	தட
tie	ட்ட
daiddaniyam	தைட்டனியம்
taitanium	தேட்டணியம்
taitaniuum	தேட்டநியம்
tetanium	தேட்டணனம்
tietanium	தீட்டணியம்
tietaniuum	தீட்டநியம்
tightaniam	டிக்டனியம்
tiitanium	திட்டநியம்
tiitaniuum	டிடன்மூம்
titaniam	டிடனியம்
titanium	திட்டணியம்
titaniumm	திட்டணியம்
titaniuum	டிடன்மூம்
titaniuumm	திட்டநியம்
dailar	தைலாரரராார்
tailer	லெல்லாட்டர்
tiler	த்லர்
tylar	திள்லர்
tyler	டிலர்
daoopakoo	தோபாகோகூ
tabago	டாக்கோகோ
tabagoo	டாக்கூ
tobaggo	டோக்கோ
tobago	டோப்காகோகோ
tobagoo	டோப்கூகோ
tobagu	தபபுக்குு
toobaggoo	டோப்கூகோ
toobagoo	டோகாகோகோ
dhonee	தொனே
dhoni	தொணினி
dhonii	தொனினி
dhoonee	தூனீ
dhooni	தூணி
dhoonii	தூனி
dhuni	துநினினி
doani	நோனினினினினினினினினினினினினினினி
donie	டோனி
donnie	டோன்னினி
dooni	னி
doonnie	டோனிய்
toni	வோனினின்
tonii	டோனி
tony	டொன்யந்னோட்டோட்டினோட்டினோ
tooni	டோனினி
toonii	நூனி
toony	நூனின்
thangich	தங்கிச்சிச்
thankich	தடங்கிச்சிச்ச்ச்ச்ச்
thangiya	டங்கியாய்
thangkiya	தங்கியைய்
thankiya	தங்கிய
thangiullathu	தங்கில்லது
thangiyulladhu	தங்கியுள்ளது
thangiyullathu	தங்கியுள்ளது
thankiyullathu	தங்கியுள்ளது
thadangalil	தடங்களில்
thadanggalil	தடங்களில்
thadangkalil	தடங்களில்
thadaya	தடையாயயயயயாய
thadayangalai	தடையங்களை
thadayanggalai	தடையங்களை
thadayangkalai	தடையங்களை
thadayangal	தடையங்கள்
thadayanggal	தடையங்கள்
thadayangkal	தடையங்கள்
thaduththa	தடுத்த்த்த்த்த்த்த்த்த்த்த்த்த்த
thaduththana	தடுத்துான
thaduththaar	தடுத்தார்
thadutthaar	தடுத்தார்
thadaigalai	தடைகளை
thadaikalai	தடைகளை
thadaykalay	தடைகளையே
thadaigalaith	தடைகளைத்
thadaikalaith	தடைகளைத்
thadaykalayth	தடைகளைத்தை
thadaipattathu	தடைபட்டது
thadaiyum	தடையும்
thadaiyai	தடையை
dakshinaamurthy	தக்ஷினாமுர்திய்
dhadchanaamoorthi	தட்சனாமூர்த்தி
dhadchinamoorthi	தட்சினமூர்த்தி
dhakshinaamoorthy	தக்சினான்றோ
tatchinamurthy	தா்்சினமுர்த்திய
thakshinaamoorththi	தக்சினாமூர்த்தை
thattaan	டட்டான்ன்
thandanai	தண்டனை
dhandanaigal	தண்டனைகள்
thandanaigal	தண்டனைகள்
thandanaikal	தண்டனைகள்
dhandanaiyilirundhu	தண்டனையிலிருந்து
thandanaiyilirundhu	தண்டனையிலிருந்து
thandanaiyilirunthu	தண்டனையிலிருந்து
thandavaala	தண்டவாலாள
dhandavaalangal	தண்டவாளங்கள்
thandavaalanggal	தண்டவாளங்கள்
thandavaalangkal	தண்டவாளங்கள்
thandin	தங்கின்
thandhira	தந்திராராரிராரி
thanthira	தந்திரிரிரி
thandhirangalil	தந்திரங்களில்
thanthirangazhil	தந்திரங்களில்
thanthiranggalil	தந்திரங்களில்
thanthirankalil	தந்திரங்களில்
thandhirangal	தந்திரங்கள்
thanthiranggal	தந்திரங்கள்
thanthirankal	தந்திரங்கள்
thandhiraththai	தந்திரத்தை
thanthiraththai	தந்திரத்தை
thanakkaaga	தனக்காக
thanakkaga	தனக்கககககக
thanithani	தனித்தனி
thaniththani	தனித்தனினி
thanikthanik	தனிக்கநிக்
thanithanik	தனித்தனிக்கிக்
thaniththanik	தனித்தணிகிக்
thanithaniyaga	தனித்தனியாக
thaniththaniyaaga	தனித்தநியாக
thanithaniyaagap	தனித்தனியாகப்
thaniththaniyaagap	தனித்தனியாகப்
thanithaniyana	தனித்தனியான
thaniththaniyaana	தனித்தனியான
thanithanmaiyana	தனித்தன்மையன்
thaniththamaiyaana	தனித்தமையான
thaniththanmaiyaana	தனித்தன்மையான
thanithanmaiyudan	தனித்தன்மையுடன்
thaniththanmaiyudan	தனித்தன்மையுடன்
thaiththuvamaana	தைத்துவமான
thaniththuvamaana	தனித்துவமான
thanithuvamana	தனித்துவமான
thaniththuvamaanadhu	தனித்துவமானது
thaniththuvamaanath	தனித்துவமானதன
thaniththuvamaanathu	தனித்துவமானது
thanithuvamanadhu	தனித்துவமாது
thanimangalin	தனிமங்களின்
thanimankalin	தனிமங்களின்
vaayaal	வாயாள்ளாள்
vayal	வயலலாலவாலவால
thabasu	தசசுுுுுுுுுுுுுுுுுுுுுுுுுுுுு
thapasu	தடபுுுுுுுுு
thamakena	தமகேகன்
thamakkaena	தமக்கேனேன்
thamakkena	தமக்கென
tamilagaththilirunthu	தமிழாகத்திலிருந்து
tamilagatthilirundhu	தமிழாகத்திலிருந்து
tamilakatthilirundhu	தமிழாகத்திலிருந்து
tamizhagatthilirundhu	தமிழகத்திலிருந்து
tamizhakatthilirundhu	தமிழக்கத்திலிருந்து
thamilagatthilirundu	தமிழாகத்திலிருந்து
thamilakatthilirundhu	தமிழகத்திலிருந்து
thamizhagatthilirundhu	தமிழகத்திலிருந்து
thamizhakaththilirundhu	தமிழகத்திலிருந்து
thamizhakaththilirunthu	தமிழகத்திலிருந்து
thamizhakatthilirundhu	தமிழகத்திலிருந்து
tamilagaththilum	தமிழாகத்திலும்
tamilagatthilum	தமிழாகத்திலும்
tamilakatthilum	தமிழாகத்திலும்
tamizhagatthilum	தமிழகத்திலும்
tamizhakatthilum	தமிழகத்திலும்
thamilagatthilum	தமிழாகத்திலும்
thamilakatthilum	தமிழகத்திலும்
thamizhagatthilum	தமிழகத்திலும்
thamizhakaththilum	தமிழகத்திலும்
thamizhakatthilum	தமிழகத்திலும்
tamilagaththu	தமிழாகத்து
tamilagatthu	தமிழாகத்து
tamilakatthu	தமிழாகத்து
tamizhagatthu	தமிழகத்து
tamizhakatthu	தமிழகத்து
thamilagatthu	தமிழாகத்து
thamilakatthu	தமிழகத்து
thamizhagatthu	தமிழகத்து
thamizhakaththu	தமிழகத்து
thamizhakatthu	தமிழகத்து
tamilagaththukku	தமிழகத்துக்கு
tamilagatthukku	தமிழகத்துக்கு
tamilakatthukku	தமிழாகத்துக்கு
tamizhagatthukku	தமிழகத்துக்கு
tamizhakatthukku	தமிழக்கத்துக்கு
thamilagatthukku	தமிழாகத்துக்கு
thamilakatthukku	தமிழகத்துக்கு
thamizhagatthukku	தமிழகத்துக்கு
thamizhakaththukku	தமிழகத்துக்கு
thamizhakatthukku	தமிழகத்துக்கு
tamilagaththai	தமிழாகத்தைத்
tamilagatthai	தமிழாகத்தை
tamilakatthai	தமிழாகத்தை
tamizhagatthai	தமிழகத்தை
tamizhakatthai	தமிழகத்தை
thamilagatthai	தமிழகத்தை
thamilakatthai	தமிழகத்தை
thamizhagatthai	தமிழகத்தை
thamizhakaththay	தமிழகத்தை
thamizhakatthai	தமிழகத்தை
tamilagaththaich	தமிழாகத்தைச்
tamilagatthaich	தமிழாகத்தைச்
tamilakatthaich	தமிழாக்கப்படைச்
tamizhagatthaich	தமிழகத்தைச்
tamizhakatthaich	தமிழகத்தைச்
thamilagatthaich	தமிழாகத்தைச்
thamilakatthaich	தமிழாகத்தைச்
thamizhagatthaich	தமிழகத்தைச்
thamizhakaththaych	தமிழகத்தைச்
thamizhakatthaich	தமிழகத்தைச்
tamilagap	தமிழாகப்
tamilakap	தமிழாகப்பபபபபபபபபபபபபபபபபபபபபபபப
tamizhagap	தமிழகப்
tamizhakap	தமிழகபபபபப்பப்
thamilagap	தமிழாகப்பப்பபபபபபபபபபபபபபபபபபபபப
thamilakap	தமிழக்பப்பப்பப்
thamizhagap	தமிழகப்
thamizhakap	தமிழக்கப்பப்
tamilagam	டமிழாகமமமகம்
tamilakam	டமிழாகமம்
tamizhagam	தமிழகமமம்கம்
tamizhakam	டமிழகமமம்கம்
thamilagam	தமிழாகமமம்
thamilakam	தமிழாகமமம்
thamizhagam	தமிழகமம்
thamizhakam	தமிழகமமம்கம்
tamilarinar	தமிழரினர்
tamilaringar	தமிழரிங்கர்
thamizharingar	தமிழரிங்கர்க்
thamizharingyar	தமிழரிங்கிரர்
tamilaiyum	தமிழாயையும்
tamizhaiyum	தமிழையும்
thamilaiyum	தமிழையும்
thamillaiyum	தமிழ்லையும்
thamizhaiyum	தமிழையும்
thambadhi	தம்பதி
thambathi	தம்பதி
thampathi	தம்பதி
thambadhigalukku	தம்பதிகளுக்கு
thambathigalukku	தம்பதிகளுக்கு
thampathikalukku	தம்பதிகளுக்கு
thambadhigal	தம்பதிகள்
thambathigal	தம்பதிகள்
thambathikal	தம்பதிகள்
thampathikal	தம்பதிகள்
thambadhikku	தம்பதிக்கு
thambathikku	தம்பதிக்கு
thambadhiyinarukku	தம்பதியினருக்கு
thambathiyinarukku	தம்பதியினருக்கு
thambadhiyinar	தம்பதியினர்
thambathiyinar	தம்பதியினர்
tayaaraanathu	தயாரானது
thayaaraanathu	தயாரானது
thayaranathu	தயறனது
dayalan	தய்லானாலன்
dhayalan	தயலான்னடனானா்
thayaalan	தயாளலானன்
thayalan	தயாளனனான்
tharakkoodiya	தரக்கூடியாய
tharakkudiya	தரக்குடியிய்
tharakkuutiya	தறக்குடிய
tharakutiya	தாகக்குடியாய்
tharakuutiya	தாக்குடியாய
tarataik	தரடைக்கைக்
tharathaik	தரத்தைக்
tharaththaik	தரத்தைக்
tharatthai	தரத்தை
tharavarisaip	தரவரிசைப்பைப்
tharavarisaiyil	தரவரிசையில்
tharavillai	தரவில்லை
tharavugalai	தரவுகளை
tharavukalai	தரவுகளை
tharavugalaith	தரவுகளைத்தைத்
tharavai	தரவை
tharuginraar	தருகின்றார்
tharukinraar	தருகின்றார்
tharukintraar	தருகின்றார்
tarunankalil	தருணங்களில்
tharunangalil	தருணங்களில்
tharunankalil	தருணங்களில்
tharunankkalil	தருணங்களில்
tarunatthai	தருணத்தை
tharunathai	தருநாதை
tharunaththai	தருநாத்தை
tharunatthai	தருணத்தை
tarunamaka	தருநமாககாக
tharunamaaga	தருநமாக
tharunamaaka	தருநமாக
tharunamaka	தருஞாமகக
dharmapuri	தர்மபுரி
thalainagaram	தலைநகரமமம்
thalaynagaram	தலைநகரமமம்
thalaynakaram	தலைநகரமமமம்
thalaimaiyidamaaga	தலைமையிடமாக
thalaimaiyidamaaka	தலைமையிடமாக
thalaimaiyidam	தலைமையிடம்
thalaimaiyaetroor	தலைமையேற்றூர்
thalaimaiyaettraar	தலைமையேற்றார்
thalaimaiyetraar	தலைமையேற்றார்
talaivanukku	தலைவனுக்கு
thalaivanukku	தலைவனுக்கு
talaivanum	தலைவனும்
thalaivanum	தலைவனும்
talaivanai	தலைவனை
thalaivanai	தலைவனை
talaivarai	தலைவரை
thalaivarai	தலைவரை
thala	தழதத்தத்
thalaththudan	தளத்துடன்
thalatthudan	தளத்துடன்
thalamaaga	தலமாக
thalamaaka	தலலாமகக
thalamaanadhu	தலமானது
thalamaanathu	தலமானது
thalamum	தளமும்
thalavaada	தவவாட
thalavaata	தளவாட
thalavaadangal	தளவாடங்கள்
thalavaadangkal	தளவாடங்கள்
thalavaadankal	தளவாடங்கள்
thalavaatankal	தலவாடங்கள்
vittathu	விட்டது
vittatu	விட்டது
poadum	போடும்
podum	பொடுமும்
potum	மொட்டும்
thavikkum	தவிக்கும்
thavil	்தில்
mudiyavillai	முடியவில்லை
mutiyavillai	முட்டியாவில்லை
thaangak	தாங்கக்ககக்க
thaangkak	தாங்கக்கக்க
thaankak	தாங்கக்கககக்க
thaangakkoodiya	தாங்கக்கூடிய
thaangakkuudiya	தாங்கக்கூடியாய
thaangkakoodiya	தாங்ககோடிய
thaankakkoodiya	தாங்கக்கூடிய
thaankakkuudiya	தாங்கக்கூடிய
thangakudiya	தங்கக்குடியாய
thaangal	தங்கள்
thaangkal	தங்கள்ள
thaankal	தாங்கள்
thaangaamal	தாங்காமல்
thaangkaamal	தாங்காமல்
thaankaamal	தாங்காமல்
dasan	தசனநனனனனனனனனனனனனனனனனனனனனனனனனனனனன
dhaasan	தாசனநன்னான்
thaasan	தாசனந்தனத்
manal	மனானலலலல்
thaadhu	தாது
thaathu	தாது
thaadhup	டாப்புப்புப்ப்ப்ப்
thaathup	ட்டுப்புப்புப்புப்
thaamiram	தாமிரமமமம்
thamiram	தமிரமமமம்
thaamboolam	தாம்பூலம்
thambulam	தம்புலம்
thaayagamaana	தாயகமான
daara	தடாரா
dara	தேரராக்டார
taara	டாட்டிட்டிட்டத்டுட்ரு
tara	திட்டிட்டரட
taraa	மாத
tarra	டற்றிட்டர்
thaaraa	தாரா
thara	தட்
thaaraavin	தாராவின்
tharavin	தரவினின்
taliban	தலிபாணன்
talibangal	தலிபங்கள்
thittamida	திட்டமிடைட்ட
thittamidal	திட்டமிடல்
thittamidum	திட்டமிடும்
dmk	ஞன்கம்ம்ம்ம்ம்ம்ம்
thimuka	திமுக்க
dmkvin	விக்கினின்
thimukavin	திமுகவின்
thiyaagaraaja	தியாகராஜாாாாாாாாாாாாாாாாாாாாாாாா
thiyaakaraaja	தியாகராஜாாாாாாாாாாாாாாாாாாாாாாாா
thyaagaraja	தையாகராஜாாாாாஜாாாாாாஜாாாாாாஜாாாா
thiyaakaraajan	தியாகராஜனான்
thiyagarajan	தியாராஜானன்
thyaagarajan	தியாகராஜனனன்
thiyaagaraajar	தியாகராஜர்
thiyaakaraajar	தியாகராஜர்ஜர்
thiyakarajar	தியாரராஜர்
tiyaakaraajar	தியாகராஜர்ஜர்
thiruchchiraappalli	திருச்சிறாப்பள்ளி
tiruchchirappalli	திருச்சிறப்பள்ளி
thiruchchiraappalliyil	திருச்சிறாப்பள்ளியில்
tiruchchirappalliyil	திருச்சிறப்பள்ளியில்
thirumangai	திருமங்கை
thirumangkai	திருமங்கை
thirumangaiyaalvaar	திருமங்கையாவ்
thirumangaiyaazhvaar	திருமங்கையாாவர்
thirumangkaiyazhvar	திருமங்கையாவ்வர்
thirumaalin	திருமாளின்
thirumalin	திருமளின்
thirumulukku	திருமுலுக்கு
thirumuluku	திருமுலுக்கு
tirumulukku	திருமுலுக்கு
thiruvarangam	திருவரங்கம்
thiruvarangkam	திருவரங்கம்
thiruvarankam	திருவரங்கம்
tiruvarankam	திருவரங்கம்
thiruvaadaanai	திருவாடானை
thiruvadanai	திருவடனைனை
thiraikku	திரைக்கு
thiraiku	திரைக்குக்
tiraikku	திரைக்கு
thiraikkup	திரைக்குப்புப்
thiraikup	திரைக்குப்புப்
tiraikkup	திரைக்குப்புப்
thiraith	திரைத்தை
tiraith	திரைத்தைத்
thiraiyin	திரையின்
thirayin	திரையின்
tiraiyin	திரையின்
thira	ததிதிரித்திதிதிதிதிதிரி
tira	டின்டிரிட்டிட்டிட்ரு
thiranum	திரணுமானம்
mikka	க்காம்க்
thiran	திரன்னார்ந்திரன்
thiranankalaiyum	திறனங்களையும்
thirangalaiyum	திறங்களையும்
thirankalaiyum	திறங்களையும்
thirangal	திரங்கள்
thirankal	திறங்கள்
theettappatta	தீட்டப்பட்ட
theettappattullathu	தீட்டப்பட்டுள்ளது
theendaamai	திண்டாமை
dheeni	தீனினி
theeni	நீனி
deepak	தேப்கககககககககககககககககககககககககககக
deepaq	தப்பாகாகாக்
dheepak	தீபாக்
diipak	தைப்பக்ககாக்க
theepak	தீபாக்ககாக்
tiipak	்ளக்ககக்
deebanggal	தீபங்கள்
deepanggal	தீபங்கள்
deepankal	தீபங்கள்
theepangal	தீபங்கள்
theepangkal	தீபங்கள்
deepan	தேபானன்
dheepan	தீபா
theepan	தீபன்
dheergadarisi	தீர்கடரிசிரிசி
theerkkatharisi	தீர்க்கத்தரிசி
theerppaayam	தீர்ப்பாயம்
theerppaal	தீர்ப்பால்
theerppin	தீர்ப்பின்
theermaaniththanar	தீர்மானித்தனர்
thuduppu	துடுப்பு
thudaippam	டுடைப்பம்
thunindhu	துனிந்துந்து
thuninthu	துனிந்து
thunburuthal	துன்புருதல்
thunburuththal	துன்புருத்தல்
thunpuruththal	துன்புருத்தல்
thuruvak	துருவககக்
thuruvam	துருவம்
dhroanar	திரோனர்
dronar	திரோனரரரரர்
thuronar	துரோணர்
dhurkkai	துர்க்கை
durgai	டுர்கைை
durkkai	துருக்கை
thuravi	துரவி
thuravigalin	துரவிகளின்
thuravikalin	துரவிகளின்
thuraigal	துறைகளளல்
thuravigal	துறவிகள்
thuravikal	துரவிகள்
thuraviyin	துரவியின்
thuraiviyum	துறைவியும்
thuraviyum	துறவியும்
thuraikkum	துறைக்கும்
thulai	துலை
thilaigalai	திலைகளை
thulaigalai	துலைகளை
thulaikalai	துலைகளை
thulaigal	துலைகள்
thulaikal	துலைகள்
thulaiththu	துழைத்துத்து
thulaithu	துலைத்து
thulaiyin	துழையின்
thulaiyil	துழையில்
thulaiyai	துழையை
thuvakathil	துவகத்தில்
thuvakkaththil	துவக்கத்தில்
thuvakkappattu	துவக்கப்பட்டு
thuvakamaga	துவகமாகக்ககமககாக
thuvakkamaaga	துவக்கமாக
thuvakkamaaka	துவக்கமாக
thuvakkam	துவக்கம்
thuvangapata	துவங்கப்பட்டத
thuvangappatta	துவங்கப்பட்ட
thuvanggappatta	துவங்கப்பட்ட
thuvangkappatta	துவங்கப்பட்ட
thuvangavillai	துவங்கவில்லை
thuvanggavillai	துவங்கவில்லை
thuvangkavillai	துவங்கவில்லை
thoodhu	தூது
thoothu	தூது
doordarshan	தோர்டர்சன்
doordharshan	தோர்தர்சன்
thoortharshan	தோர்சர்ஷன்
thoolaith	டோத்துத்
thuulaith	துளைத்தைத்தைத்தைத்
therigiradhu	தெரிகிறது
therigirathu	தெரிகிறது
therkaaga	தெற்காக
therkaaka	தெற்காக
therkkaaka	தேர்க்காக
therkilirunthu	தெற்கிலிருந்து
therkkilirundhu	தேர்கிலிருந்து
thaekka	க்க
thekka	திக்க
thaengaip	தேங்கைப்
thaenkaaip	தேங்காய்
thengaip	தெங்கைப்பைப்
thaer	ாத்தித்
ther	தெர்
thaerndhedukkum	தேர்ந்தெடுக்கும்
thaernthedukkum	தேர்ந்தெடுக்கும்
thernthedukkum	தெர்ந்தெடுக்கும்
thaervin	தேர்வின்
thervin	தேர்வின்
thaervil	தேர்வில்
thervil	தெர்வில்
thaervai	தேர்வைை
thervai	தேர்வை
devalaya	தேவலையாய
thevaalaya	தேவாளயயாலய
devaalayam	தேவாலயம்
devalayam	தேவலையம்
thevaalayam	தேவாளய
deviyar	தேவியர்
theviyar	தேவியர்
thoguththa	தொகுத்து
thoguththaar	தொகுத்தார்
thoguppin	தொகுப்பின்
thokupin	தொகுப்பினின்
thokuppin	தொகுப்பின்பின்
thoguppilum	தொகுப்பிலும்
thokupilum	தொகுப்பிலும்
thokuppilum	தொகுப்பிலும்
thoguppil	தொகுப்பில்
thokupil	தொகுப்பில்
thokuppil	தொகுப்பில்பில்
thoguppaiyum	தொகுப்பையும்
thokupaiyum	தொகுப்பையும்
thokuppaiyum	தொகுப்பையும்
thogaigal	தொகைகளை
thokaikal	தொகைகளால்
tokaikal	தாக்களாக்கள்
thogaikku	தொகைக்கு
thokaikku	தொகைக்கு
thokaiku	தொகைக்கு
thogaiyaanthu	தொகையான்து
thokaiyaanathu	தொகையானது
thokaiyanathu	தொகையானது
thogaiyin	தொகையின்
thokaiyin	தொகையின்
tokaiyin	தோக்கையின்
thogaiyee	தொகையீ
thokaiye	தொகையேயே
thokaiyee	தொகையீ
thogaiyai	தொகையை
thokaiyai	தொகையையை
tokaiyai	தோகையை
thokaiyaik	தொகையைக்கைகை
tokaiyaik	தோகையைகை
thoda	தொடோட்
thota	தட்டோட்டோ
thodaraana	தொடரானான
thodarukku	தொடருக்கு
thodarbukalil	தொடர்புகளில்
thodarpukalil	தொடர்புகளில்
thotarpukalil	தொடர்புகளில்
totarpukalil	தொடர்புகளில்
thodarbukalum	தொடர்புகளும்
thodarpukalum	தொடர்புகளும்
thotarpukalum	தொடர்புகளும்
totarpukalum	தொடர்புகளும்
thodarbugalaiyum	தொடர்புகளையும்
thodarbukalaiyum	தொடர்புகளையும்
thodarpukalaiyum	தொடர்புகளையும்
thodarbugal	தொடர்புகள்
thodarbukal	தொடர்புகள்
thodarpukal	தொடர்புகள்
thodarbukku	தொடர்புக்கு
thodarpukku	தொடர்புக்கு
thodarbudan	தொடர்புடன்
thodarpudan	தொடர்புடன்
thodarbuth	தொடர்புத்து
thodarputh	தொடர்புத்துத்து
thodumpoothu	தொடும்போது
thodumpothu	தொடும்போது
thotumpothu	தொடும்போதுது
thottu	தோட்டு
thotu	தட்டு
tholainokki	தொலைநோக்கி
tholainookki	தொலைநோக்கி
tholainokkiyai	தொலையொக்கியை
tholainookkiyai	தொலைநோக்கியை
tholaipaesi	டடலாபசிசி
tholaipesi	டோலைப்சிசிசி
tholaipaesialil	தொலைபேசிலில்ல்
tholaipesigalil	தொலைபெசிகளில்
tholaipesikalil	தொலைபெசிகளில்
tholilin	தொழிலின்
thozhilin	தொழிலின்
tholilil	தொழிலில்
thozhilil	தொழிலில்
tholuthaar	தொழுதாரார்
thozhuthaar	தொழுதாரார்
tholumpoathu	தொலும்போது
thozhumpoathu	தொழும்போது
thozhumpoothu	தொழும்போது
thozhumpothu	தொழும்போது
thoandum	தோண்டும்ம்
thondum	தொண்டும்
thoontum	தோண்டும்
thondriya	தோன்றியிய்ய
thontriya	தோன்றியிய்
thoontriya	டோன்றியிய்
thondriyadhaal	தோன்றியதால்
thondriyathaal	தோன்றியதால்
thontriyathal	தோன்றியதால்
thoontriyathaal	தோன்றியதால்
thondriyulladhu	தோன்றியுள்ளது
thondriyullathu	தோன்றியுள்ளது
thontriyulathu	தோன்றியுள்ளது
thoontriyullathu	தோன்றியுள்ளது
thoamas	தோமஸ்மோசாசாசாசாசாசஸ்மா
thomas	தமாசதமா
dhoranai	தோரணை
thoaranai	தோரணை
thoarruvikka	தோற்றுவிக்க
thoatruvikka	தோற்றுவிக்க
thoattruvikka	தோற்றுவிக்க
thoarruviththavar	தோற்றுவித்தவர்
thoatruviththavar	தோற்றுவித்தவர்
thoattruviththavar	தோற்றுவித்தவர்
thoarruviththaar	தோற்றுவித்தார்
thoatruviththaar	தோற்றுவித்தார்
thoattruviththaar	தோற்றுவித்தார்
thoarruviththu	தோற்றுவித்து
thoatruviththu	தோற்றுவித்து
thoattruviththu	தோற்றுவித்து
thoalvikku	தோல்விக்கு
tholvikku	தொல்விக்கு
tholviku	தொல்விக்கு
thoolvikku	தூள்விக்கு
thoalvikkup	தோல்விக்குப்
tholvikkup	தொல்விக்குப்
tholvikup	தொல்விக்குப்புப்
thoolvikkup	தோல்விக்குப்புப்
thoalviyil	தோல்வியில்
thoalviyae	தோல்வியே
thoalviyaith	தோல்வியைத்
nagaraththaich	நகரத்தைச்
nadakkiradhu	நடக்கிறது
nadakkirathu	நடக்கிறது
nadaiperaadha	நடைபெறாதாத
nadaiperaatha	நடைபெறாத
nadiperaadha	நடிபெறாதாத
nadaiperaamal	நடைபெறாமலன
nadaiperuvadhai	நடைபெறுவதை
nadaiperuvathai	நடைபெறுவதை
moolaam	மூலாம்
moolam	மல்மம்மம்ம
mulam	ொழம்
nadhigalum	நதிகளும்
nadhigazhum	நதிகளும்
nadhikalum	நதிகளும்
nathigalum	நதிகளும்
nathikalum	நதிகளும்
nadhik	அதிக்
nathik	்சிக்
nadhiyaana	நதியானானானான
nathiyaana	நாத்தியான
nadhiyilirunththu	நதியிலிருந்து
nadhiyilirunthu	நதியிலிருந்து
nathiyilirunthu	நதியிலிருந்து
nadhiyil	நதியில்லில்
nathiyil	நதியிலில்
nadhiyaiyum	நதியையும்
nadiyaiyum	நடியையும்
nathiyaiyum	நதியையும்
naththam	நாத்தம்
nanmai	ந்மைமைமை
nannanmy	நண்ணாம்மி
nanmaigalai	நன்மைகளை
nanmaigazhai	நம்மைகளை
nanmaikalai	நன்மைகளை
nanmaigalaip	நன்மைகளைப்பை
nanmaigazhaip	னன்மைகளைப்
nanmaikalaip	நன்மைகளைப்பை
nanmaigal	நன்மைகள்
nanmaikal	நன்மைகள்
nanmaikaka	நன்மைக்ககக
nanmaikkaaga	நன்மைக்காக
nanmaikkaaka	நன்மைக்காக
nanmaiyaaga	நன்மையாக
nanmaiyaaka	நன்மையாக
nanmaiyaka	நன்மையாயகக
nanmaiyae	நன்மையேயே
nanmaiyaiye	நன்மையையே
nanmaiyaiyee	நன்மையையே
nanmaiye	ந்மைய்யை
nayathodu	நயதொடுடு
nayathotu	நயதத்தோடு
nayaththoadu	நயத்தோடு
nayaththodu	நயத்தொடு
nayatthootu	நயயத்தூடு
nayam	னையம
narachiman	நரசிமினன்
narachimman	நறச்சிம்மன்மன்
narasimman	நரசிமிம்மன்மன்
narambugalai	நரம்புகளை
narambukalai	நரம்புகளை
narampukalai	நரம்புகளை
narambugal	நரம்புகள்
narambukal	நரம்புகள்
narampukal	நரம்புகள்
narpanbugal	நற்பன்புகள்
narpanbugazh	நற்பன்புகள்
narpanbukal	நற்பன்புகள்
narpanpukal	நர்பன்புகள்
nala	நாலான
nalla	நல்லான்
vali	வளி
vazhi	வழிஷாஜு
nallaar	நல்லார்
nalloar	நல்லூர்
nalloor	நல்லூரூர்
nalor	நலர்னர்லான்
nalan	அழனநனனான்ன
naliravu	நலிறவு
nalliravu	நல்லிரவுவு
nav	நவான்
nava	நாவவான்
naw	நவவன்ன
nawa	நவவான்ன்
noa	நானோன்ன்ன
nov	நோவோன்ன்ன்ன்ன்
now	நோவோன்ன்ன்ன்
navachakthi	நவச்சாத்தி
navasakthi	நவசக்தி
navashakthi	நவசாத்தி
navami	நவமிமி
navam	நவம்மமன்ம
naveenath	நவீனதனத்
naveenaththuva	நவேநத்துவது
naveenaththuvam	நவேநாத்துவம்
naveenam	நவேநமனம்
naveen	அவீனின்
naviin	வின்னி
navin	ந்னின்
naween	நவீன்னின்
nawiin	நவீநின்
nawin	நினின்
naagareegangalil	நாகரீகங்களில்
naagareegangazhil	நாகரீகங்களில்
naagareeganggalil	நாகரேகங்களில்
naagareegaththai	நாகரேகத்தை
naasaavin	நாசாவின்
nasavin	நசவவினின்
naasaavil	நாசாவில்
nasavil	நசவில்
naasi	நாசி
nasar	நசசர்நானான
nasr	நிற்ரான்ஸ்ன்
nasra	நிர்ரன்்ரான்
naanchil	நான்சில்
nanchil	நன்சிலில்
nanjil	நஞ்சில்
naadukadaththa	நாடுகடத்தத்த
naadukadattha	நாடுகடத்தத்த
naadukadaththappatta	நாடுகடத்தப்பட்ட
naadukadatthappatta	நாடுகடத்தப்பட்ட
naadoadi	நாடோடிடி
naadodi	நாடொடிடி
naadoodi	நாடூடி
naattavargal	நாட்டவர்கள்
naattavargazh	நாட்டவர்கள்
naattiya	நாட்டிய
naattiyaththil	நாட்டியத்தில்
naattiyap	னாட்டியப்பப்பப்
naana	நானான
naanaa	நானான்னான்
nana	நனனானான்
nanaa	நன்னானானான்
naanooru	நானூரு
naaraayanaaya	ஞாராயணாயாய
narayanaya	நாராயணையானை
naarpathu	நார்பது
naarpathukkum	நார்பதுக்கும்
naatraththai	நாற்றத்தை
naattraththai	நாற்றத்தை
nigara	நிகரரான்
nikara	நிகரரன்
nigalthagavu	நிகழ்தாகவு
nigazhthagavu	நிகழ்தகவு
nikazhthakavu	நிகழ்த்தகவு
nigalththa	நிகழ்த்த்த
nigazhththa	நிகழ்த்த்த்
nikazhththa	நிகழ்த்த்த
nigalththappadum	நிகழ்த்தப்படும்
nigazhththappadum	நிகழ்த்தப்படும்
nikazhththappadum	நிகழ்த்தப்படும்
nigalvugalaal	நிகழ்வுகளால்
nigalvugazhaal	நிகழ்வுகளால்
nigazhvugalaal	நிகழ்வுகளால்
nikazhvukalaal	நிகழ்வுகளால்
nigalvugalin	நிகழ்வுகளின்
nigalvugazhin	நிகழ்வுகளவின்
nigazhvugalin	நிகழ்வுகளின்
nikazhvukalin	நிகழ்வுகளின்
nigalvugalaip	நிகழ்வுகளைப்
nigalvugazhaip	னிகழ்வுகளைப்
nigazhvugalaip	நிகழ்வுகளைப்பைப்
nikazhvukalaip	நிகழ்வுகளைப்
nigalvugalaiyum	நிகழ்வுகளையும்
nigalvugazhaiyum	நிகழ்வுகளையும்
nigazhvugalaiyum	நிகழ்வுகளையும்
nikazhvukalaiyum	நிகழ்வுகளையும்
nigalvum	நிகழ்வும்
nigazhvum	நிகழ்வும்
nikazhvum	நிகழ்வும்
nigalvai	நிகழ்வை
nigazhvai	நிகழ்வை
nikazhvai	நிகழ்வை
nigalvaip	னிகழ்வைப்
nigazhvai	நிகழ்வை
nigazhvaip	னிகழ்வைப்
nikazhvaip	நிகழ்வைப்
nigalvaiyum	நிகழ்வையும்
nigazhvaiyum	நிகழ்வையும்
nikazhvaiyum	நிகழ்வையும்
nicotin	நிகோட்டன்
nicotine	நிகோட்டின்
nikoatin	நிகோட்டின்
nesan	னேசன்ன்
nessan	நேசன்னன்
nisaan	நிசன்
nisan	னிசன்னன்
nissan	னிசன்சன்னினான்
nissann	நிசன்ந்்ந்னன்
ninaivaagavum	நினைவாகவும்
ninaivaakavum	நினைவாகவும்
niyamanam	நியமனமம்
niyamika	நியமிக்க
niyamikka	நியமிக்க
nirubar	நிறுபர்
nirupar	நிருப்பர்
nirvagikka	நிர்வகிக்க
nirvakikka	நிர்வகிக்காக்க
nirvagikkum	நிர்வகிக்கும்
nirvakikkum	நிர்வகிக்கும்
nirvaaga	நிர்வாக
nirvaaka	நிர்வாக
nirvaagak	நிர்வாகககககககககககககககககககககககககக
nirvaagangal	நிர்வாகங்கள்
nirvaaganggal	நிர்வாகங்கள்
nirvaagath	நிர்வாகத்தத்
nirvaagaththirkum	நிர்வாகத்திற்கும்
nirvaagaththilum	நிர்வாகத்திலும்
nirvaakaththilum	நிர்வாகத்திலும்
nirvaagaththil	நிர்வாகத்தில்
nirvaagamum	நிர்வாகமும்
nirvaakamum	நிர்வாகமும்
nirvakamum	நிர்வகமும்
niraivurum	நிறைவுறும்
nilak	நிலக்னைக்க
nilakkadalai	நிலக்கடலை
nilainiruththa	நிலைஞருத்த்த்
nilainiruththik	நிலைநிறுத்திக்
nilainiruththum	நிலைநிருத்தும்
nee	நே
nii	நினினின்
neettik	நீட்டிக்கி
neettippu	ன்றிப்புப்ப்
neethaan	நீதான்னான்
neethu	நீது
neetu	நீடுந்துன்
neeyae	நீயே
neeyea	யேனே
neeraetram	நீரேட்ரம்
neeraetrtram	நீரேட்டிரம்
neereatram	நீரேற்றமம்
neerai	நீரை
neeraith	நீரைத்தைத்
neeraip	ைப்
neeraiyum	நீரையும்
naro	நாரோன்
nearo	நேரூனின்
neero	னிறூன்ன்
neeroa	நீரோவோன்
neeroo	நீரோரோ
nero	நேரோரனன்
neroo	நேரோரான்
niiro	ஆன்
niiroo	நிரூரோ
niro	ஆர்மான்
niroo	நிரூரோன்
neeroadu	நீரோடுடு
neeroattanggal	நேரோட்டங்கள்
neeroattangkal	நேரோட்டங்கள்
neeroattankal	நேரோட்டங்கள்
neeroattaththin	நீரோட்டத்தின்
neeroattaththil	நீரோட்டத்தில்
neeroattam	நேரோட்டம்
neerroattam	நீர்டோட்டம்
neermattam	நீர்மட்டம்டம்
neervala	நீர்வளளல்
neervalam	நீர்வளமம்
nun	நுன்ன
nunmai	நுமண்மை
nuraiyeeralin	நுரையீரலினி
nuraiyiiralin	நுரையிரலின்
nuraiyeeralil	நுரையீரலில்
nuraiyiiralil	நுறையிரலில்
nuraiyeeral	நுரையீரல்
nuraiyiiral	நுரையிரலிரல்
nulainththa	நுழைந்த்த்
nuzhaindha	நுழைந்த
nuzhinththa	நுழிந்த்த்
nulainthathaal	நுழைந்ததால்
nuzhaindhadhaal	நுழைந்ததால்
nuzhinththathaal	நுழிந்ததால்
nulainthathu	நுழைந்தது
nuzhaindhadhu	நுழைந்தது
nuzhinththathu	நுழிந்தது
nulainththathum	நுழைந்ததும்
nuzhaindhadhum	நுழைந்ததும்
nuzhinththathum	நுழிந்ததும்
nulainthana	நுழைந்தன
nuzhaindhana	நுழைந்தன
nuzhinththana	நுழிந்தநான
nulainththanar	நுழைந்தனர்
nuzhaindhanar	நுழைந்தனர்
nuzhinththanar	நுழிந்தனர்
nulainthapoathu	நுழைந்தபோது
nuzhaindhapoadhu	நுழைந்தபோது
nuzhinththapoathu	நுழிந்தபோது
nulainththaar	நுழைந்தார்
nuzhaindhaar	நுழைந்தார்
nuzhinththaar	நுழிந்தார்
nootriyettu	நூற்றியேட்டு
nootrtriyettu	நூற்றியேட்டு
noottriyettu	நூற்றியேட்டு
noolaga	ஓூககலான
noolaka	நூலகாக்்
noolagangalil	நூலகங்களில்
noolagangkalil	நூலகங்களில்
noolakangalil	நூலகங்களில்
noolakangkalil	நூலகாங்களில்
noolagangal	நூலகங்கள்
noolagangkal	நூலகங்கள்
noolakangal	நூலகங்கள்
noolakangkal	நூலகாங்கள்
noolagath	நூலகததததத
noolakath	நூலகத்தததததததததததததததததததததததததத
noolagaththirku	நூலகத்திற்கு
noolakaththirkku	நூலகத்திற்கு
noolakaththirku	நூலகத்திற்கு
noolagaththil	ுூலகத்தில்
noolakaththil	நூலகத்தில்
noolagaththai	நூலகத்தை
noolakaththai	நூலகத்தை
noolagamum	நூலகமும்
noolakamum	நூலகமும்
noolum	ளமும்
noolae	இூலே
noole	இுலை
neduncheralathan	நெடுஞ்செரலத்தன்
nedunjchaeralaathan	நெடுஞ்செறலாதன்
nedunjeralaadhan	நெடுஞர்லாதன்
nedunjeralaathan	நெடுஞர்லாதன்
nerippaduththum	நெரிப்படுத்தும்
nerri	நேரி
netri	த்றினின்
nettri	நெற்றி
netrip	ன்ரிப்ரிப்ரிப்ரிப்ரிப்ரிப்ரிப்ரி
nettrip	னெற்றிப்பிப்பிப்பிப்பிப்பிப்பிப்
nelsan	நெல்சன்னன்
nelson	நில்சன்
naeyargal	ஞாயர்கள்
neyargal	ஞாயர்கள்
neyarkal	ஞாயர்கள்
neerittathu	நீரிட்டது
neritathu	நெரிடது
nerittadhu	நேறிட்டது
nerittathu	நேறிட்டது
neerittaal	நீரிட்டால்
nerital	நேறிட்டல்
nerittaal	நேரிட்டால்
naooyda	நோய்த்தா
noida	நோய்ட
noidaa	ஓய்தானான்
noyda	நோட்டான்ன்
noyta	நோய்லுகன்
noytaa	மோய்
noakki	நோக்கி
nokki	நோக்கி
noakkith	கோக்கித்தி
nokip	னீப்
nokkip	ன்கிப்பி
nookkip	ப்
nokiye	நோக்கியேயே
nokkiye	நோக்கியை
nookkiyee	நூக்கியேய்
nokil	கோகில்
nokkil	ஒக்கில்
nookkil	ஒழிக்கில்
nooyinai	நோயினை
noyinai	நோயினை
noaiththotru	நோய்த்தொற்று
noayththotru	நோய்த்தொற்று
noiththottru	நோய்த்தொற்று
pagadai	பகடை
pakadai	பகடை
baka	பாகக்பபாக்கப்பாக்
bakaa	பாகா
bhaga	ஹக்பாகப்
pakaa	பாகாப்பாபாகப்புப்பாபாபாபாப
bhageerathan	பகேரதனதன்
pakeerathan	பகேரதானன்
pakiirathan	பகி
pakirathan	பகிரதானன்
paguthiyaith	பகுதியைத்
pakuthiyaith	பகுதியைத்
paguppaaivu	பகுப்பாய்வு
paguppaayvu	பகுப்பாவ்வு
pakuppaaivu	பகுப்பாய்வு
pangkuthaarar	பங்குதாரர்
panguthaarar	பங்குதாரரரரரரரரரரரரரரரரரரரரரரரரர
pankuthaarar	பங்குதாரர்
pankutharar	பங்குதரரர்
panguthaarargalaaga	பங்குதாரர்களாக
panguthaararkalaaka	பங்குதாரர்களாக
panguthararkalaka	பங்குதரர்களாக
pankuthaararkalaaka	பங்குதாரர்களாக
bangkuthaararkalin	பங்குதாரர்களின்
panguthaarargalin	பங்குதாரர்களின்
pankuthaararkalin	பங்குதாரர்களின்
pankuthararkalin	பங்குதரர்களின்
bangkuthaararkal	பங்குதாரர்கள்
panguthaarargal	பங்குதாரர்கள்
pankuthaararkal	பங்குதார்கள்
pankuthararkal	பங்குதரர்கள்
pasukkalin	பசுக்களினின்
pasukkazhin	பசுக்களின்
pasukkalil	பசுக்களில்
pasukkazhil	பசுக்களில்
pasukkal	பசுக்கள்
padangalin	படங்களின்
padangkalin	படங்களின்
pandangalin	பண்டங்களின்
padangalilum	படங்களிலும்
padangkalilum	படங்களிலும்
pandangalilum	பண்டங்களிலும்
padangalukkum	படங்களுக்கும்
padanggalukkum	படங்களுக்கும்
padangaludan	படங்களுடன்
padanggaludan	படங்களுடன்
padappidippu	ுடப்பிடிப்பு
padappidippugal	படப்பிடிப்புகள்
padappidippukal	படப்பிடிப்புகள்
padarndhu	படர்ந்து
padarnththu	படற்ந்து
padarnthu	படற்ந்து
padala	படலல
padalangal	படலங்கள்
padalankal	படலங்கள்
padalaththil	படலட்தில்
padigalin	படிகளின்
padikalin	படிகளின்
padigal	படிகள்
padikal	படிகள்
padikku	படிக்கு
poluthu	பொழுது
polutu	பொழுத்து
pozhuthu	பொழுது
padidhal	படிதல்லால்
padithal	படிதல்
padinilai	படினிலை
padinilaigalil	படினிலைகளில்
padinilaikalil	படினிலைகளில்
padipai	படிபை
padippai	படிப்பை
patippai	படிப்பை
padipaith	படிப்பைத்
padippaith	படிப்பைத்தைத்
patippaith	படிப்பைத்தை
padipaiyum	படிபையும்
padippaiyum	படிப்பையும்
patippaiyum	படிப்பையும்
padimangalai	படிமங்களை
padimangazhai	படிமங்களை
padimankalai	படிமங்களை
patimankalai	படிமங்களை
padimathin	படிமதினின்
padimaththin	படிமத்தின்
padimatthin	படிமத்தின்
patimatthin	பட்டிமத்தின்
padimam	படிமமம்ம்
patimam	படிமம்
padiyil	படியில்
patiyil	படியில்
paduthiya	படுத்தியாய
paduththiya	படுத்தியிய்
padutthiya	படுத்தியிய்
patuthiya	படுதிய
paduthiyathu	படுத்தியது
paduththiyadhu	படுத்தியது
paduththiyathu	படுத்தியது
padutthiyathu	படுத்தியது
patutthiyathu	படுத்தியது
paduththiyulladhu	படுத்தியுள்ளது
paduththiyullathu	படுத்தியுள்ளது
padaithathu	படைத்தது
padaiththathu	படைத்தது
padaitthathu	படைத்தது
pataitthathu	படைத்தது
padaithanar	படைத்தனர்
padaiththanar	படைத்தனர்
padaitthanar	படைத்தனர்
pataitthanar	படைத்தனரனர்
padaithalapathi	படைத்தப்பத்தி
padaiththalapathi	படைத்தளப்பத்தி
padaitthalapathi	படைத்தளபதத்தி
pataitthalapathi	படைத்தளபதபதத்தி
padaithan	படைத்தன்
padaiththaan	படைத்தான்றான்
padaitthaan	படைத்தான்ன்
pataitthaan	படைத்தான்னான்
padaiththu	படைத்து
padaithu	படைத்து
padaitthu	படைத்து
pataitthu	படைத்து
padaipaka	படைப்பகககககககககககககககககககககககககக
padaippaakka	படைப்பாக்க
padaippakka	படைப்பக்க
pataippaakka	படைப்பாக்க
padaiyinarum	படையினரும்
pataiyinarum	படையினரும்
pattathu	பட்டது
panayak	க்கக்கக்
panigalin	பணிகளினின்
panigazhin	பணிகளினின்
panigalukku	பணிகளுக்கு
panigazhukku	பணிகளுக்கு
panigalukkup	பணிகளுக்குப்
panigazhukkup	பணிகளுக்குப்
panigalukkum	பணிகளுக்கும்
panigazhukkum	பணிகளுக்கும்
panigalum	பணிகளும்
panigazhum	பணிகளும்
panigalai	பணிகளை
panigazhai	பணிகளை
panigalaip	பணிகளைப்பைப்
panigazhaip	பணிகளைப்பை
panigalaiyum	பணிகளையும்
panigazhaiyum	பணிகளையும்
panigal	பணிகள்
panigazh	பணிகள்
panikkaana	பணிக்கான
panithan	பணிதானந்தன்
paniththaan	பநித்தான்னான்
panitthaan	பணித்தான்ன்
panimanai	பணிமணை
paniyaanadhu	பணியானது
paniyaanathu	பணியானது
paniyin	பணியின்
paniyilirindhu	பணியிலிருந்து
paniyilirunthu	பணியிலிருந்து
paniyilum	பணியிலும்
paniyum	பனியும்
panpaadu	பண்பாடு
panbaadugalin	பண்பாடுகளின்
panpaadugalin	பண்பாடுகளின்
panpaadugazhin	பண்பாடுகளின்
panpaadukalin	பண்பாடுகளின்
panbaadum	பண்பாடும்
panpaadum	பண்பாடும்
padhikkappatta	பதிக்கப்பட்ட
pathikkappatta	பதிக்கப்பட்ட
padhinaezhyaam	பதினேழ்யாம்
pathinaelaam	பதினேலாமா
pathinaezhaam	பதினேழாம்
pathinealaam	பதினேயால்
pathineazhaam	பதினேழாம்
pathinezhaam	பதினேழாம்
padhinoaraavadhu	பதினோராவது
pathinaoraavathu	பதினொறாவது
pathinoaraavathu	பதினோராவராது
padhippiththa	பதிப்பித்த்த்த்த்த்த்த்த்த்த்த்த
pathippiththa	பதிப்பித்தித்த
pathippittha	பதிப்பிட்த்த்த்த்த்த்த்த்த்த்த்த
padhippiththullaar	பதிப்பித்துள்ளார்
pathippiththullaar	பதிப்பித்துள்ளார்
pathippitthullaar	பதிப்பிட்துள்ளார்
padhulaiyil	பதுளையில்
pathulaiyil	பதுளையில்
paththaandu	பத்தாண்டு
paththaandugalaaga	பத்தாண்டுகளாக
paththaandukalaaka	பத்தாண்டுகளாக
paththaandugalil	பத்தாண்டுகளில்
paththaandukalil	பத்தாண்டுகளில்
paththaandugal	பத்தாண்டுகள்
paththaandukal	பத்தாண்டுகள்
padmanaaban	பட்மணாபன்
pathmanaaban	பத்மநானனானன்
pandhiyil	பந்தியில்
panthiyil	பந்தியில்
panththiyil	பந்தியில்
panimalai	பணிமலை
pannirandaam	பண்ணிரண்டாம்
pannirendaam	பண்ணிரண்டாம்
pannirendu	பண்ணிரண்டு
pandri	ுற்றிஷி
panri	ப்ரி
pandrikalin	பன்றிகளின்
panrigalin	பன்றிகளின்
panrikalin	பன்றிகளின்
pandrikalai	பன்றிகளை
panrigalai	பன்றிகளை
panrikalai	பன்றிகளை
pandrikal	பன்றிகளளல்
panrigal	பன்றிகள்
panrikal	பன்றிகள்
pandriyin	பன்றியின்
panriyin	பன்றியின்
bambaram	பம்பரமம்
pambaram	பம்பரமமம்
pamparam	பம்பறமரம்
cet	சத்்
pamp	ம்பம்ப்பம்ப்்
pump	்சும்பு
puump	்ளுப்புப்பு
set	செட்டஸ்ஸ்ஸ்டஸ்்
payanamaanaar	பயனமானார்
payaniththu	பயணித்து
payanithu	பயணித்து
payanpaduththavillai	பயன்படுத்தவில்லை
payanpaduththuvathai	பயன்படுத்துவதை
payanpaduthuvathai	பயன்படுத்துவதை
payanpatuththuvathai	பயன்படுத்துவதை
payir	
payirgalin	பயிற்களின்
payirkalin	பயிற்களின்
payirgalil	பயிற்களில்
payirkalil	பயிற்களில்
payirgalukku	பயிற்களுக்கு
payirkalukku	பயிற்களுக்கு
payirgalum	பயிற்களும்
payirkalum	பயிற்களும்
paiyrkalaith	பைய்களைத்தைத்
payirgalaith	பயிற்களைத்
payirkalaith	பயிற்களைத்தைத்
paiyrch	்ச்ச்ச்ச
payirch	ச்சிற்சிற்ச்ச்ச்ச்ச்ச்ச்ச்ச்ச்சி
baiylvaan	பைல்வான்னான்
bayilvaan	பயில்வான்
paiylvaan	பயில்வான்
payilvaan	பயில்வான்
barathaechi	பரதேசிசி
paradesi	பரடேசிசிசிசிசிசிசிசிசிசிசிசிசிசி
paradhesi	பரரேஷிசிசிசிசி
parathaechi	பரதேசிசி
parathesi	பரதேசிசிசிசி
parapalavai	பரபலவைை
parappalavai	பரப்பழவை
parappazhavai	பரப்பழவை
parappurai	பரப்புறை
parappuraigalai	பரப்புறைகளை
parappuraigazhai	பரப்புறைகளை
parappuraikalai	பரப்புறைகளை
parichoathiththu	பரிசோதித்து
parisoathiththu	பரிசோதித்து
parimaatraththil	பரிமாற்றத்தில்
parimaattraththil	பரிமாற்றத்தில்
parimaatraththai	பரிமாற்றத்தை
parimaattraththai	பரிமாற்றத்தை
parimaatramum	பரிமாற்றமும்
parimaattramum	பரிமாற்றமும்
parumanaal	பருமணால்
paruman	பருமனன்
barnaalaa	பர்நாளாாாாாாாாாாாாாாாாாாாாாாாாாா
barnala	ஞார்னலான
parnaalaa	பர்நாளாாாாாாாாாாாாாாாாாாாாாாாாாா
parikka	பரிக்காக்காக்காக்காக்காக்காக்காக
parikkum	பரிக்கும்
palagaigal	பழகைகள்
palagaikal	பலகைகள்
palakaikal	பலகைகள்
palagaiyin	பழகையின்
palakaiyin	பலகையின்னை
palagaiyil	பழகையில்
palakaiyil	பழகையில்
balaththa	பலத்த்த
palaththa	பழத்த்த
palaridam	பலரிடம்
palavaaraaga	பலவாராக
palavaaraaka	பலவாராக
paliyiduthal	பளியிடுதலத
paliyiduvathu	பளியிடதுவது
pallavargal	பல்ளவர்கள்
pallum	பல்லும்மம்
balu	புுளுழுள்ளுப்புல்லப்
palu	பலுப்
pazhu	பழுப்புப்புப்புப்புப்புப்புப்புப
bharathi	பரதி
palani	பலனி
parati	பாத்தி
pazhani	நழனி
pazhu	பழுப்புப்புப்புப்புப்புப்புப்புப
pazhavaettaraiyar	பழவேட்டரையாயர்
pazhuvettaraiyar	பழுவெட்டரையர்
pavi	பவிப்பவபப்பாப்
paula	பாலோல்லாப்ப்பப்ப்பப்ப்ப்
paulaa	பசலா
pauula	லப்புப்ப்ப்ப்
pauulaa	பூல்லாபாலாலாலா
pavula	பவுள்ளு
poola	பூல்வோப்லுபோப்போப்லோ
pula	புலுப்புப்புலுப்
paakisthaanukku	பாகிஸ்தானுக்கு
pakistanukku	பகிஸ்தானுக்கு
pakisthanukku	பகிஸ்தநுக்கு
paagupaadu	பாகுபாடுடு
paakupaadu	பாகுப்பாடுடு
paagupaadum	பாகுபாடும்
paakupaadum	பாகுபாடும்
baacyaraaj	பாசியராஜாாாாாாாாாாாாாாாாாாாாாாாா
baagyaraaj	பாகியராஜாாாாஜாாாாாாாாாாாாாாாாாாா
baakkiyaraaj	பாக்கியராஜாாாாாாாாாாாாாாாாாாாாாா
baakyaraaj	பாகிரராஜாாாாாாாாாாாாாாாாாாாாாாாா
bagyaraj	பக்கரரஜாஜாாஜாாஜாராஜாாஜாரஜாஜ
bakyaraaj	பக்கராஜாாாாாாாாாாாாாாாாாாாாாாாாா
bhakkiyaraaj	பக்கியராஜாாாாாாாாாாாாாாாாாாாாாாா
baangaak	பாங்காக
baangkaak	பாங்காக
bangkok	பங்கோகோகோகோக்கோகோகோகோக்கோகோக்கோக
bangqoq	பங்கோக்கோக்கோக்கோக்கோக்கோக்கோகோக
pankak	பங்ககக்கக்
paandavargalil	பாண்டவர்களில்
paandavarkalil	பாண்டவர்களில்
paantavarkalil	பாண்டவர்களில்
pandavargalil	பண்டவர்களில்
paandavargalukkum	பாண்டவர்களுக்கும்
paandavarkalukkum	பாண்டவர்களுக்கும்
paantavarkalukkum	பாண்டவர்களுக்கும்
pandavargalukkum	பண்டவர்களுக்கும்
paandavargalum	பாண்டவர்களும்
paandavarkalum	பாண்டவர்களும்
paantavarkalum	பாண்டவர்களும்
pandavargalum	பண்டவர்களும்
paandavargalai	பாண்டவர்களை
paandavarkalai	பாண்டவர்களை
paantavarkalai	பாண்டவர்களை
pandavargalai	பண்டவர்களை
paandavargal	பாண்டவர்கள்
paandavarkal	பாண்டவர்கள்
paantavarkal	பாண்டவர்கள்
pandavargal	பண்டவர்கள்
baathagaththai	பாதகத்தை
paathagaththai	பாதகத்தை
paathakaththai	பாதகத்தை
baathip	பாதிபிப்
paathip	்பிபிப்
paadhiyaaga	பாதியாக
paathiyaaka	பாதியாக
paadhiyil	பாதியில்
paathiyil	பாதியில்
baathai	பாதை
paathai	வபை
baathaikalin	பாதைகளின்
paathaikalin	பாதைகளின்
baathaikalum	பாதைகளும்
paathaikalum	பாதைகளும்
baathaikalai	பாதைகளை
paathaikalai	பாதைகளை
baathaaikku	பாதாய்க்கு
paathaaikku	பாதாய்க்கு
paathaikku	பாதைக்குக்கு
paathaiyil	பாதையில்
paathaiyai	பாதையை
paathaiyaik	பாதையைகை
paathaiyaip	பாதையைப்
baanangal	பாணங்கள்
baanangkal	பாணங்கள்
baanankal	பாணங்கள்
paanankal	பாணங்கள்
baanaththil	பானத்தில்
paanaththil	பாணத்தில்
baanaththai	பானத்தை
paanaththai	பாணத்தை
baanam	மாமம்ம்
paanam	பாணமமம்மம்மம்
baabaavin	பாபாவின்
babeel	பாபலில்
babel	பபெல்ல்ல்லில்ல்ல்ல்லல்
baebal	ேபலலலலலலலலலலலலலலலலலலலலலலலலலலலலலல
baebel	பேபெல்
baeebal	ாபலலால்
baeebeel	பேபிலில்
beeybalee	பேபலீ
beibale	பிபாலலேல்
beybale	ப்பலேல்
papeel	பபேல்
baarathiya	பாரதியாய்ய
bhaarathiya	பாரதியாய
bharathiya	பரதியாய்
baarathiyaar	பாரதியார்
bhaarathiyaar	பாரதியார்
bharathiyaar	பரதியார்
paariya	பாரியாய்
paariyalavilaana	பாரியளவிலான
baaru	பாரு
paaru	காறுபு
paarkkum	பார்க்கும்ம்
paalum	ுளுமும்
paaluravu	பாலுரவு
paalootti	பாலூட்டிட்டி
paaluutti	பாலுட்டி
paaloottigalil	பாலூட்டிகளில்
paaloottikalil	பாலூட்டிகளில்
paaluuttigalil	பாலுட்டிகளில்
paaluuttikalil	பாலுட்டிகளில்
paaloottigal	பாலூட்டிகள்
paaloottikal	பாலூட்கிகள்
paaluuttigal	பாலுட்டிகள்
paaluuttikal	பாலுட்டிகள்
paal	பாளாபாபாப்புப்பா்போப்புப்பா்போப்
paazh	பா்பாழ்
baava	பாவவவவவாவா
bhaava	பாவவ
paava	பாவ
bhaavangalukku	பாவங்களுக்கு
paavangalukku	பாவங்களுக்கு
paavangkalukku	பாவங்களுக்கு
paavankalukku	பாவங்களுக்கு
bhaavangal	பாவங்கள்
paavangal	பாவங்கள்
paavangkal	பாவங்கள்
paavankal	பாவங்கள்
baavanai	பாவனை
bhaavanai	பாவணை
paavanai	பாவனை
baavanaiyil	பாவனையில்
bhaavanaiyil	பாவனையில்
paavanaiyil	பாவனையில்
bisin	ிசின்
pichin	சிசினினின்
pisin	பிஷினின்
pithappai	பிதப்பைை
piththappai	பித்தப்பை
bindhu	நிந்து
pinthu	நிந்து
pinbura	பின்புர்றுறார்
pinpura	பின்புர்ர்ர்ர்ர்ர்ர்ர்ர்ர்ர்ர்ர்
pinburamaaka	பின்புரமாக
pinpuramaaga	பின்புரமாக
pinpuramaaka	பின்புரமாக
binvaanginaar	பின்வாங்கினார்
binvaangkinaar	பின்வாங்கினார்
pinvaanginaar	பின்வாங்கினார்
pinvaangkinaar	பின்வாங்கினார்
pigmees	பிகம்ஸ்ஸ்
pigmies	யிக்மிசீஸ்சிஸ்சரசசஸ்ஸ்
pygmees	ஃபிெச்சிஸ்ஸிஸஸ்
pygmies	பிக்மிசஸ்ஸ்சரசசஸ்ச்சரசசஸ்சீஸ்ஸ்
pygmiis	பிக்மீசிசிசிசிஸ்
pyjmees	ஃஞ்சீஸ்
pyjmies	யிஸ்மிசஸ்சிஸ்ஸ்
pirachaara	பிரசாராராராரா
pirasaara	பிரசாராராராராராராராராராராராராரார
prachaara	பிரசாராரா
pirachaaram	பிரசாரமம்
pirasaaram	பிரசாரமமமம்
prachaaram	பிரசாரமாம்
pirachurankal	பிரசுரங்கள்
pirasurangal	பிறசுரங்கள்
pirasurangkal	பிறசுரங்கள்
prachurankal	பிரசுரங்கள்
prasurankal	பிரசுரங்கள்
pirachuram	பிரசுரமரம்
pirasuram	பிரசுரம்
prachuram	பிரச்சுறமரம்
prasuram	பிரசுரமம்
piradhaanap	பிரதானப்பப்பப்பப்பப்பப்பப்பப்பப்
pirathaanap	பிரதானப்பப்பப்பப்பப்பப்பப்பப்பப்
piradhaanamaaga	பிரதானமாக
pirathaanamaaka	பிரதானமாக
piradhaanamaana	பிரதானமான
pirathaanamaana	பிரதானமான
piraththiyaekamaaka	பிரத்தியேகமாக
pirathyaekamaaka	பிரத்தேகமாக
pirathyeagamaaga	பிரத்தேகமாக
piraththiyaekamaana	பிரத்தியேகமான
pirathyaekamaana	பிரத்தேகமான
pirathyeagaamana	பிரத்திகாமனன
cankar	சங்கர்
pirapu	பிறப்புப்புப்புப்புப்புப்புப்புப
prabhoo	திரபோபோ
prabhu	பிரபுப்பு
prabhuu	பிரபுபு
prabu	பிரபுப்பு
prabuu	பிரபுபு
sangkar	சங்கர்
sankar	சங்கர்கரர்்
shankar	சங்கரர்கரர்
pirabhukkal	பிரபுக்கள்
pirabukkal	பிரபுக்கள்
prabukkal	பிரபுக்கள்
pirabhuvin	பிரபுவின்
pirabuvin	பிரபுவின்
prabhuvin	பிரபுவின்
prabuvin	பிரபுவின்
probuvin	ரொபுவினின்
bhramma	பிரம்ம்ம்
biramma	பிரம்ம்ம்ம
brahma	பிர்மாம்ம்ம்ம்ம்ம்ம்ம்ம்ம்ம்ம்ம்
brahmma	பிரம்ம்ம்ம்ம்ம்ம்ம்ம்ம்ம்ம்ம்ம்ம
bramma	பிரம்மாம்ம்ம்ம்ம்ம்ம்
piramma	பிரம்ம்ம்ம்ம்ம்ம்ம்ம்ம்ம்ம்ம்ம்ம
brammaththai	பிரம்மத்தை
pirammaththai	பிரம்மத்தை
brammanai	பிரம்மனை
pirammanai	பிரம்மணை
brammam	ரர்மம்மமம்மம்மம்மம்மம்மம்மம்மம்ம
pirammam	பிரம்மமம்மம்
pirammum	பிரம்மும்
piraveen	பிரவேநினின்
praveen	கிரவேநினின்
piravaecha	பிறவேச்சச்சச்சச்சச்சச்சச்சச்சச்ச
piravaesa	பிரவேசசசசசாச
piravesa	பிரவேசேசசசசசசசசசசசசசசசசசசசசசசசசச
pravaesa	ரிவாேசேசசாசாச
braamanargalum	பிராமணர்களும்
braamanarkalum	பிராமணர்களும்
piraamanarkalum	பிராமணர்களும்
praamanarkalum	பிராமணர்களும்
piritha	பிரித்த
piriththa	பிரித்த
priththa	பிரித்த்த்த்த்த்த்த்த்த்த்த்த்த்
pirithanar	பிரித்தனர்
piriththanar	பிரித்தனர்
priththanar	பிரித்தனர்
pirithaar	பிரித்தாரார்
piriththaar	பிரித்தார்
priththaar	பிரித்தார்
pirivinarae	பிரிவினரை
privinarae	பிரிவினரேே
piraemaa	பிரேமாமா
praemaa	ரேமாமாாம்மா
prema	பிரமமமமமமமம்ம
premaa	ரிமாாாாாாாாாாாாாாாாாாாாாாாாாாாாா
piraem	பிரேம்மிமைம்
pireem	ேதிமீம்மி
praem	ுரேம்மேம்மைம்ம்
praim	ன்றைமைம்
preeim	ுரீமிம்
preem	ுனீமிமிம்
preemm	மிசிமம்
preim	ுன்மிமிம்
prem	ன்மமரம்
premm	்மெம்மமம்
talankalil	தளங்களில்
thalanagalil	தளனாளில்
thalangalil	தலங்களில்
thalangkalil	தலங்களில்
pirandhadhaaga	பிறந்ததாக
piranthathaaka	பிரந்ததாக
pirandhadhaal	பிரந்ததால்
piranthathaal	பிரந்ததால்
pirandhadhu	பிரந்தது
piranthathu	பிரந்தது
pirandhana	பிரந்தநான
piranthana	பிரந்தன
pirandhanar	பிரந்தனர்
piranthanar	பிறந்தனர்
pirandhapoadhu	பிரந்தபோது
piranthapoathu	பிரந்தபோபுது
piranthapoothu	பிரந்தபோது
piranthavudan	பிரந்தவுடன்
piranthavutan	பிரந்தவுடன்
piranthavai	பிறந்தவை
vittaal	விட்டால்
vittal	விட்டல்
piranthirullathu	பிரந்திருள்ளது
piranthullathu	பிரந்துள்ளது
pirappai	பிரப்பை
pirarukku	பிரருக்கு
piraroadu	பிறரோடு
piraroatu	பிறரோடு
piraroodu	பிறரூடுடு
pirkaala	பிர்காலால்
pirkaalangalil	பிர்காலங்களில்
pirkaalanggalil	பிர்காலங்களில்
pirkaalangkalil	பிர்காலங்களில்
pirgaalaththu	பிர்காலத்து
pirkaalaththu	பிர்காலத்து
pele	பெல்லே
pilae	பிளே
blackberry	பிளாக்பர்ூர்
pilaakperri	பிளாக்கெற்றிரி
pilaalperri	பிளால்பெற்றிரி
plackperry	பிளாக்ப்பெர்
pilaanet	பிளாணெட்டட்டை
pilaant	பிளாண்ட்ட்ட்ட்ட்ட்ட்ட்ட்ட்ட்ட்ட்
plaant	பிளான்ட்ட்ட்ட்ட்ட்ட்ட்ட்ட்ட்ட்ட்
planet	பிளான்
plant	பிளாந்த
pilai	பிலை
pizhai	பிழை
pilaikalai	பிளைகளை
pizhaigalai	பிழைகளை
pilaikal	பிளைகள்
pizhaigal	பிழைகளிலள்
pilaiyaaka	பிளையாக
pizhaiyaaga	பிழையாக
be	பப்ளபப்புபிபுபிபுபிபுபிரபபப்புபப
bea	பேயேப்ளி
bee	பாபிபேபிளேபிபிபேபுபிபிபேபிரபபப்ப
bii	்்
pee	பேபேப்பிப்பப்பப்ப்பேப்
pii	பிப்பிப்பிப்பிப்பிப்பிப்ப்ப்ப்ப்
beatti	பேட்டி
beatty	பேட்டி
beaty	டேட்டி
beetty	பட்டி
betty	பட்டி
piiddi	ட்டி
beatlej	ாய்லிசேச்சிசிஜ்ஜ்ஜ்்
beatles	பாட்டசஸ்சஸ்சிஸஸ்சரஸ்ஸ்ஸ்ஸ்ஸ்ர்ஸ்
beatless	பெட்சலஸ்ஸ்ஸ்ஸ்ஸ்ஸ்ஸ்ஸ்ஸ்ஸ்ஸ்ஸ்ஸ்
beatlez	ோட்ளிளேச்ஜ்ஜ்ஜேஜ்ஜ்ஜேஜ்ஜ்ஜேஜ்ஜ்ஜ
beetles	பட்செலஸ்ஸ்ஸ்ரச்சஸ்சேஸ்சரசசசசசசசச
beetless	பெல்டிசஸ்ஸ்ஸ்ஸ்ஸ்ஸ்ஸ்ரஸ்ஸ்ஸ்ஸ்ரஸ
beetlez	பெல்லெஜ்ஜிஜேஜ்ஜேஜ்ஜேஜ்ஜ்ஜேஜ்ஜேஜ்
betles	டட்சிலஸ்டெஸ்சர்ஸ்
betless	பட்லஸ்ஸ்ஸ்்
betlez	ெட்லெச்செல்ஜேச்ச்செச்சேசேச்சேச்ஜ
biitles	பீட்டிலஸ்ஸ்ஸ்ர்ஷேசஸ்சேஸ்சேஸ்ஸ்ஸ்
beepi	பீபிபி
peepe	பேப்பிய்்ஸ்
peepi	பீபிபி
beeris	சிசிசிசி
peeris	சிசிசி
pugalpetrtra	புகல்பெற்று
pukalpetrtra	புகல்பெற்ற்ற
pukalpettravai	புகழ்பெற்றவை
pukazhpetra	புகழ்ப்பேற்ற
pukazhpettravai	புகழ்ப்பெற்வவை
pugalpetrtravai	புகல்பெற்றவை
pukalpetrtravai	புகழ்பெற்றவை
pukalpettravai	புகழ்பெற்றவை
pukazhpetravai	புகழ்ப்பெற்வவை
pukazhpettravai	புகழ்ப்பெற்வவை
pugalpetrtraar	புகல்பெற்றார்
pukalpetrtraar	புகல்பெற்றார்
pukalpettraar	புகழ்பெற்றார்
pukazhpetraar	புகழ்ப்பேற்றார்
pukazhpettraar	புகழ்ப்பேற்றார்
pugaaril	புகாரில்
pukaaril	புகாரில்
pudhusu	சூு
puthusu	தூசு
puduchcheari	புடுச்சிரிரி
puthuchchaeri	புதுச்சேரி
puthucheri	புதுச்செரி
puduchcheariyil	புடுச்சிரியில்
puthuchchaeriyil	புதுச்செரியில்
puthucheri	புதுச்செரி
pudhuchcheariyai	புதுச்சீரியை
puthuchchaeriyai	புதுச்சேரியை
puthucheri	புதுச்செரி
pudhumai	புதுமைமை
puthumai	புதுமை
pudhumaigalai	புதுமைகளை
pudhumaikalai	புதுமைகளை
puthumaigalai	புதுமைகளை
puthumaikalai	புதுமைகளை
pudhumaigal	புதுமைகள்
pudhumaikal	புதுமைகள்
puthumaigal	புதுமைகள்
puthumaikal	புதுமைகள்
pudhuvaiyil	புதுவையில்
puthuvaiyil	புதுவையில்
pudhuvaiyai	புதுவையை
puthuvaiyai	புதுவையை
pudhaiththu	புதைத்து
puthaiththu	புதைத்து
buddharin	புத்தரினின்
budhdharin	புத்தரினி
buththarin	புத்தரினின்
puththaandup	புத்தாண்டுப்பு
punidhar	புனிதரிதர்
punithar	புனித்தர்
punidhargal	புணிதர்கள்
punitharkal	புணிதர்கள்
punaindhu	புணைந்து
puratchigara	புரட்சிகரராகர்
puratchikara	புரட்சிகரராகர்
purigindrana	புரிகின்றன
puriginrana	புரிகின்றன
purikindrana	புரிகின்றன
puriginaranar	புரிகினரரனர்
purigindranar	புரிகின்றனர்
purikindranar	புரிகின்றனர்
puridhal	புரிதல்
purithal	புரிதல்
purindhum	புரிந்தும்
purinthum	புரிந்தும்
purivadhu	புரிவது
purivathu	புரிவது
puraa	புராருபுடாப்பு
puraakkal	புராக்கள்
puraavin	புராவின்
noayaaga	ஓயாக
noayaaka	ஓயாகாக
noyaka	நோயகக்கான்
pulambi	புலம்பிப்பி
pulampi	புலம்பி
pulampeyarnthu	புலம்பெயர்ந்து
pulavar	புலவரர்
pulavargalai	புலவர்களை
pulavarkalai	புலவர்களை
pulavargal	புலவர்கள்
pulavarkal	புலவர்கள்
eerppu	ஈ்பு
irppu	ம்ப்பு
puviyeerppu	புவியிப்புப்பு
puviyai	புவியை
poongulali	பூண்குழலி
poonguzhali	பூங்குழலி
puungkulalil	பூங்குலளில்
poochchu	ஊச்சுச்
puuchchu	ூச்சுப்புர்டு
poochchugal	பூச்சுகள்
poochchukal	பூச்சுகள்
puuchchugal	பூச்சுகள்
puuchchukal	பூச்சுகள்
bhutan	புத்தனடன்
poodaan	பூடான்னோன்
pootaan	பூடான்
puudaan	பூடான்னுபான்
puutaan	பூட்டான்
boaut	பூடோப்டோ
boauut	ோட்டோ
boot	போட்டோ
but	படுகூபுகுவுப்துப்
puud	ோயுடுப்புப்ு
poonagariyil	பூனகரியில்
poonakariyil	பூனகரியில்
puunagariyil	பூணகரியில்
puunakariyil	பூணக்கிரியில்
poona	ஓரோபோன்போன்
poonaa	ஒனாாா
puna	வனனு
punaa	புனானா
pune	ந்னு்புன்்
puuna	உத்யுப்பு்பு்்
puunaa	பூணா
poonai	பொைை
puunai	ைப்
poonaiyin	பூணையின்
becki	பெக்கி
becky	பாக்கி
becqy	கப்கிச்கீக்ஸ்
paekki	்கி
peggi	பெக்கி
peggy	பெக்கி
pennukkum	பெண்ணுக்கும்
peyaraal	பெயரால்
peyarinai	பெயரினை
peyarin	ெயரினின்
peyarilum	பெயரிலும்
peyaro	ஞாயர்
peyaroa	பெயராயோ
peyaroo	பெயரோர்பூர்யூர்
periyadhaaga	பெரியதாக
periyathaaka	பெரியதாக
periyadhaagavum	பெரியதாகவும்
periyathaakavum	பெரியதாகவும்
periyadhu	பெரியது
periyathu	பெரியது
periyadhum	பெரியதும்
periyathum	பெரியதும்
periyar	பெரியர்
periyavaraaga	பெறியவராக
periyavaraaka	பெரியவராக
periyaarin	பெரியாரின்
periyarin	பெரியரின்
periyaarukku	பெரியாறுக்கு
periyarukku	பெரியருக்கு
perugiyathu	பெறுகியது
perukiyathu	பெறுகியது
peruthal	பெறுதல்
peruvathargaaga	பெருவதற்காக
peruvatharkaaga	பெருவதற்காக
peruvatharkaaka	பெருவதற்காக
peruvatharkaagavum	பெருவதற்காகவும்
peruvatharkaakavum	பெருவதற்காகவும்
petrtruththanththathu	பெற்றுத்தந்தது
pettruththandhadhu	பெற்றுத்தந்தது
pettruththanththathu	பெற்றுத்தந்தது
baurnami	பௌர்நாமி
paurnami	பார்னமிமி
pournami	பௌர்னாமி
powrnami	பௌர்னமி
pack	பச்்
pacq	்கா்
paeek	பேகேப்ப்ப்ப்ப்ப்ப்ப்ப்ப்
paek	கேக்
paeq	பெக்
paik	ைக்ப்
paiq	்ேைப்ப்
pak	தாப்பப்பா்பப்
paq	ைகாகப்பிப்பரப்பாப்பாப்பாப்பாப்பா
peek	பீக்ஸ்
pek	கேக்
paechupavarkal	பேசுபவர்கள்
paesubavargal	பேசுபவர்கள்
pesupavarkal	பேசுபவர்கள்
paeththi	பேத்தி
peaththi	பேத்தி
peththi	பெத்தி
bearaasiriyarum	பேராசிரியரும்
paeraasiriyarum	பேராசிரியரும்
pearaasiriyarum	பேராசிரியரும்
baee	பேபாபாபாபா
bai	பைப்பைப்பைப்பைபாபாபைபாபாபைப்பப்
baii	்பைப்பைபாபைபா
bie	பிபிபிரி
biee	பிபிரிப்ரி
bye	ப்ய்்
byee	பியீ
byii	
paai	்பாய்ப்பப்பாப்பிப்
paaii	
pae	பேபேப்பப்பப்புப்பேப்பேப்பேப்பப்ப
pai	்ப்பப்பப்பப்பைப்பப்பபப்பைப்பைப்ப
paii	்ப்
pie	பிப்பிப்பிப்பிப்பிப்பிப்பிப்பிப்
piie	பியே
paigalil	பைகளில்
paikalil	பய்களில்
paigal	பைகல்கள்
paikal	பைகள்
paitan	பைட்டண்டன்
paithon	பைத்தோனன்
paithonn	பைட்டன்
paython	பயத்தொன்ன்
pethonn	பெத்தொன்ன்ன்ன்ன்ன்ன்ன்ன்ன்ன்ன்ன்
pithon	பித்தொன்
pithonn	பித்தொன்ன்ன்
python	பித்தொன்
pythonn	பித்தொன்ன்ன்ன்ன்
baibil	பிலில்
bible	ப்பெல்லில்லில்லி
paipil	பைபிள்
paiyanai	பயலைனை
paiyin	ந்யிப்பினின்
paiyil	ையில்லிலிலில்
pongku	ங்கு
pongu	ஞ்குவ்
pongkum	பங்கும்ம்
pongum	பங்கும்
pottu	வோட்டு
podhumai	பொதுமைமை
pothumai	பொதுமைமை
ponnaiyum	பொன்னையும்
poriththu	போரித்துத்துத்
poruththappattana	பொருத்தப்பட்டன
poruththappattirukkum	பொருத்தப்பட்டிருக்கும்
porundha	பொருந்து
porundhdha	பொருந்து
poruntha	பொருந்த
porundhavillai	பொருந்தவில்லை
porundhdhavillai	பொருந்தவில்லை
porunthavillai	பொருந்தவில்லை
porulaaga	பொருளாக
porulaaka	பொருளாக
porulaagavum	பொருளாகவும்
porulaakavum	பொருளாகவும்
porulaagaum	பொருளாகும்
porulaakum	பொருளாகும்
poraamai	பொராமைமை
poraamaiyin	பொராமையின்
porimurai	பொரிமுறைறை
poruththadhu	பொருத்தது
poruththathu	பொருத்தது
poruppaettra	பொறுப்பேற்றை
poruppeattra	பொருப்பேற்ற
poruppetra	பொறுப்பெற்ற
porupeattradhu	பொருபெற்றது
poruppaettrathu	பொருப்பேற்றது
poruppetrathu	பொறுப்பெற்றது
poruppaettru	பொறுப்பேற்று
poruppetru	பொறுப்பெற்று
poruppettru	பொறுப்பெற்று
polanaruvai	பொலனருவை
poolanaruvai	பூலனருவை
poluthupokkaaka	பொழுதுபோக்காக
poluthupookkaaka	பொழுதுபோக்காக
pozhudhupoakkaaga	பொழுதுபோக்கோக
poluthupokku	பொழுதுபோக்கு
poluthupookku	பொழுத்துக்கு
pozhudupoakku	பொழுடுபோக்கு
poluthum	பொழுதும்
pozhudhum	பொழுதும்
poaga	ஓபோபோப்பு
poga	போகோபோப்கோபோ
poagap	கப்போப்போப்போப்பு
pogap	கபபபோப்போப்போப்போப்கப்
bhogi	போகிகி
boagi	போகி
bogei	போகி
bogey	பாகியோ
bogi	புகி
bogie	பூகி
boogey	பூகியேய்
boogie	கி
poagi	போகி
pooki	பூகிகி
poagiraen	போகிரேனியேன்ேன்
poagirean	போகிரியன்
poagumboadhu	போகும்போது
poagumpoathu	போகும்போது
poakkuvaraththil	போக்குவரத்தில்
poakkuvaraththai	போக்குவரத்தை
boat	போட்போட்டோப்
poat	போட்டோப்புப்போப்பு
poatti	ப்
poattigalai	போட்டிகளை
poattik	உட்டிக்கிக்கோக்
poattikkaaga	போட்டிக்காக
poattikkaana	போட்டிக்கான
poattiyaana	போட்டியான
poattiyaanathu	போட்டியானது
poattiyaandahu	போட்டியாண்டகு
poatiyaalar	போட்டியாளர்
poattiyaalar	போட்டியாளர்
poattiyaalargal	போட்டியாளர்கள்
poattiyaalarkal	போட்டியாளர்கள்
poattiyin	போட்டியின்
poattiyilum	போட்டியிலும்
poattiyil	போட்டியில்
boatil	போட்டிலில்
boattil	பட்டில்
poattil	போட்டிலில்
poandra	போன்று
poanra	ஆன்ரோப்புர்
poantra	போன்று
poayinar	போயினர்
poyinar	பொயினர்
bauron	பரரண்்ன்
bauroon	போரோனான்
bauuron	போரனன்
boaraan	நோரான்னான்
booraun	ஆணுராண்
booroon	பூரணன்
boraun	னோணு
borauun	போரூண்
boron	போரணன்்ன்்
poaraan	போரான்
pooran	பூரண்
poarththukkaeyar	போர்த்துக்கேயர்
poarththukkeyar	போர்த்துக்கேயர்
porththukkeyar	பொர்த்துக்கீயர்
portugaeyar	பொர்ட்டுகேயர்
poala	போலோ
pola	போலோபோல்
poalath	போலத்தபது
polath	போலத்தோ
poalavum	போலவும்
polavum	போலவும்
poalavoa	போலவோவோ
polavo	லாவவோவோவோ
bola	போலோ
bolaa	ஆலோகாலா
bolla	போ்ல
boola	போல்லோ
boolaa	ஆல்லா
boolla	ஞுல்ல
bula	பூலுவு
poola	பூல்வோப்லுபோப்போப்லோ
poavathu	வோவது
povathu	வோது
poavathum	போவதும்
povathum	போவதும்
bro	்ரோரூரோ
broa	புரோரோோ
fro	்ரோன்ரிவ்ர்ர்
pro	பிரோப்ரூப்ரி
proa	ருவோப்ரோப்ரோப்புரோப்
magadha	மகததாத
magatha	மகததத்த
makadha	மகததத
makatha	மகததாத
magalaith	ளைதை
makalaith	மைத்தைத்
makalath	மகளதாததாத
magaa	மகாசாகா
magha	மாகாம்மகமம
maghaa	மேகா
majha	ுஷாசாம்
majhaa	ு
maka	மாககம்ம
makaa	மகாாாாமாம்
magaadaevi	மகாடேவிவி
magaadevi	மகாதேவி
magaadhaevi	மகாதேவிவி
magaathaeve	மகாதேவே
mahadevi	மகதேவி
makaadaevi	மகாடேவி
makaadhaevi	மகாதேவிவி
makaathaevi	மகாதேவிவே
mahaaiana	மகாயணன
mahaayana	மகாயணன
mahaiaana	மகேயானான
mahaiana	மகேயணன
mahaianaa	மஹைதனானானா
mahayaana	மகேயானானான
mahayana	மகேயணன
mahayanaa	மஹகானானாாாாாாாானா
makayan	மகையன்
magaalatchumi	மகாலட்சுமி
mahaalaksmi	மகாலாஸ்மி
mahalatchumi	மகாலாஜ்சுமி
makaalatchumi	மகாலட்சுமி
magaaveerar	மகாவீரர்
mahaveer	மகாவிர்
mahaveerar	மகாவேரர்
makaaveerar	மகாவேரர்
magaaveer	மகாவேர்
mahaveer	மகாவிர்
makaaveer	மகாவேர்
magilnthu	மகிழ்ந்து
magizhunthu	மகிழுந்து
makilnthu	மகிழ்ந்து
makizhunthu	மகிழுந்து
magilchchi	மகிழ்ச்சிச்
magizhchchi	மகிழ்ச்சிச்சி
makilchchi	மகிழ்ச்சி
makizhchchi	மகிழ்ச்சி
magilchchiyaaga	மகிழ்ச்சியாக
makilchchiyaaka	மகிழ்ச்சியாக
makizhchchiyaaka	மகிழ்ச்சியாக
magilchchiyaana	மகிழ்ச்சியான
makilchchiyaana	மகிழ்ச்சியான
makizhchchiyaana	மகிழ்ச்சியான
magilchchiyil	மகிழ்ச்சியில்
makilchchiyil	மகிழ்ச்சியில்
makizhchchiyil	மகிழ்ச்சியில்
magilchchiyutan	மகிழ்ச்சியுடன்
makilchchiyudan	மகிழ்ச்சியுடன்
makizhchchiyudan	மகிழ்ச்சியுடன்
magilchchiyum	மகிழ்ச்சியும்
makilchchiyum	மகிழ்ச்சியும்
makizhchchiyum	மகிழ்ச்சியும்
mahesan	மஹேசன்
makaechan	மகேசன்
makaesan	மகேசனன்
maahees	ஜேசஷஸ்
maahes	சேசேஸ்
maahesh	சசஸ்சஷ்
mahees	ஜெசீஸ்
maheesh	ஷஷஷ்ஷ்ஷ்
mahes	சேசேமஸ்ஸ்்
mahesh	ிஷேஷ்சஷ்
maheshh	்ச்
makaesh	கேஷ்
makeesh	கேஷ்ஷ்
machuuthikku	மசுதிக்கு
masoothikku	மசோதிக்கு
masuthikku	முதுக்குக்கு
masuuthikku	மசுதிக்கு
machuuthiyin	மசுதியின்
masoothiyin	மசோதியின்
masuthiyin	மசுதியின்
masuuthiyin	மசுதியின்
machuuthiyai	மசுதியையை
masoothiyai	மேஷூதையை
masuthiyai	மொதுதியை
masuuthiyai	மௌதூதையை
manjula	மஞ்சுழ்ளுள
manjulaa	மஞ்சுழாாாாாாாாாாாாாாாாாாாாாாாாாா
manamaagaatha	மனமாகாதாகத்
manamaakaatha	மனமாகாத
maninaeramum	மணிநேரமும்
manineramum	மணிநரறைமும்
maniyam	மணியம்
mandaal	மண்டாள்ள
mandal	மாண்டலாலலாலலாலலாலலாலலாலலாலலாலலால
mathippaaga	மதிப்பாக
mathippaaka	மதிப்பாக
mathippeettai	மதிப்பீட்டை
madhdhiya	மத்தியயாய்
maththiya	மத்தியாயிய
madhdhiyatharaik	மத்தியதரைகை
maththiyatharaik	மத்தியதறைக்கைை
pirateca	பிரடெக்கச்
piratecam	பிரடெசமகம்
pirathaesa	பிரதேசேசேச
pirathaesam	பிரதேசம்
piratheasa	பிரதேசாசாசாச
pradhaesa	பிரதேசாசிரசுசேச
pradhaesam	பிரதேசம்
mandha	மந்தா
mantha	நந்தா
mandhamaana	மந்தமான
manthamaana	மந்தமான
mandham	மந்தம்
mantham	மந்தமம்ம்
manitharai	மணிதரை
manai	ைமு
manaigal	மனைகள்
manaikal	மனைகள்
manaikku	மனைக்கு
marakkattaigal	மறக்கட்டைகள்
marakkattaikal	மறக்கட்டைகள்
marabinar	மரபினரணினரர்
maravallik	மரவலள்களிகள்
maravallilk	மரவல்லிற்க்க்கள்
maruththuvamanai	மருத்துவமைை
maruththuvamanaigalil	மருத்துவமைகளில்
maruththuvamanaikalil	மருத்துவமைகளில்
maruththuvamanaigalum	மருத்துவமைகளும்
maruththuvamanaikalum	மருத்துவமைகளும்
maruththuvamanaigal	மருத்துவமைகள்
maruththuvamanaikal	மருத்துவமைைகள்
maruththuvamanaiyai	மருத்துவமையை
marunthin	மருந்தின்
marunthil	மருந்தில்
marai	மே
marainr	ந்தைன்ரன்்
marinar	மரினரர்
mariner	மரினர்
marain	மரைன்
marine	ரமினேன்
marukka	மருக்கா்க்கா்க்கா
marukkappattu	மருக்கப்பட்டு
marukkavae	மருக்கவே
vittaargal	விட்டார்கள்
vittaarkal	விட்டார்கள்
vittarkal	விட்டர்கள்
matravargalidam	மற்றவர்களிடம்
matrtravarkalidam	மற்றவர்களிடம்
matrtravarkalitam	மற்றவர்களிடம்
mattravarkalidam	மற்றவர்களிடம்
matravargalin	மற்றவர்களின்
matrtravargalin	மற்றவர்களின்
matrtravarkalin	மற்றவர்களின்
mattravarkalin	மற்றவர்களின்
matravargalum	மற்றவர்களும்
matrtravargalum	மற்றவர்களும்
matrtravarkalum	மற்றவர்களும்
mattravarkalum	மற்றவர்களும்
matravargalaith	மற்றவர்களைத்
matrtravarkalaith	மற்றவர்களைத்தைத்
mattravarkalaith	மற்றவர்களைத்
matravargalaiyum	மற்றவர்களையும்
matrtravargalaiyum	மற்றவர்களையும்
matrtravarkalaiyum	மற்றவர்களையும்
mattravarkalaiyum	மட்டவர்களையும்
matravargal	மற்றவர்கள்
matrtravargal	மற்றவர்கள்
matrtravarkal	மற்றவர்கள்
mattravarkal	மற்றவர்கள்
malarae	மலராேே
malaraiyum	மலரையும்
malargalil	மலர்களில்
malarkalil	மலர்களில்
malargalaik	மலர்களைக்களை
malarkalaik	மலர்களைக்கை
malargalaith	மலர்களைத்
malarkalaith	மலர்களைத்தைத்
malargalaiyum	மலர்களையும்
malarkalaiyum	மலர்களையும்
malarmaalai	மலற்மாலை
malaiyadivaara	மலையடிவார
malaiyadivaaraththil	மலையடிவாரத்தில்
maadan	மாடனடன்
maatan	மாட்டனான்
modern	மோடர்னர்ன்்
maanikka	மாநிக்க்க்க்க்க்க்க
manicka	மனிக்காக்க
manickka	மனிச்க்க
maanikkam	மாநிக்கம்மகம்
manickam	மணிக்கம்
maadhulai	மாதுளை
maathulai	மாதுளை
maara	மமராம்ம
mara	மும
maraa	மேராாமா
maarbai	மற்பைை
maarpai	மாற்பைை
maaraaga	மாறாகாக
maaraaka	மாறாககாக
maattramadaiyum	மாற்றமடையும்
mattramadaiyum	மட்டமடையும்
thiranaaligalukkaana	திறனாளிகளுக்கான
thiranaalikalukkaana	திறனாளிகளுக்கான
tiranalikalukkana	திரணலிகளுக்கான
maattrup	மாற்றுப்புப்புப்புப்புப்புப்புப்
maatruvathai	மாற்றுவதை
maattruvadhai	மாற்றுவதை
maattruvathai	மாற்றுவதை
maali	சாலி
maalii	மாலி
mali	மலி
malii	மலி
maalik	மாலிக்கி
malik	மாிக்மிக்
maliq	பாலிக்
maalai	ுமைை
malai	மலே
maalaigal	மாலைகள்
maalaikal	மாலைகள்
poluthil	பொழுதில்லில்
polutil	பொழுடில்
pozguthil	பொல்குதில்
pozhuthil	பொழுதிலில்
maalaiyum	மாலையும்
maalaiyai	மாலையை
maaligaikku	மாழிகைக்கு
maalikaikku	மாழிக்கு
maaligaiyilirundhu	மாளிகையிலிருந்து
maalikaiyilirunthu	மாளிகையிலிருந்து
maaligaiyil	மாளிகையில்
maalikaiyil	மாழிகையில்
maasgoavin	மாகோவாவின்
maaskoavin	மாஸ்கோவின்
maaskoovin	மாஸ்கோவின்
moscowin	மாகோகினினின்
mikkadhaagavum	மிக்கதாகவும்
mikkathaakavum	மிக்கதாகவும்
mikkadhu	மிக்கது
mikkathu	மிக்கது
mikkavan	மிக்கவனானந்தனன்
mikkavaraaga	மிக்கவராக
mikkavaraaka	மிக்கவராக
mikkavar	கிக்கவர்
mikkavargal	மிக்கவர்கள்
mikkavarkal	மிக்கவர்கள்
mikkavai	மிக்கவை
mickee	மிக்கீ
mickei	மிக்கி
mickey	மிக்கெயயய்
micki	்கி
mickii	மிக்கி
mickiy	மிக்கியைய்
micky	க்க்ம்
micqee	மிக்கீ
micqey	மிக்கெயயய்
micqii	மிக்கி
micqiy	மிக்கியி
micqy	க்கிமி
mikei	கி
mikey	மிக்கியே
mikii	மிக்கி
mikki	பிக்கி
miqey	மிகியீ
miqii	மிகி
miththiran	மித்திரன்
mesion	மேசனயோன்
mishan	மிஷன்மான்மஷ்
mision	யசினியோன்
misionn	சியோன்னன்னன்
mission	ுசியோன்யோன்யோன்யோனியோனியோனியோனிய
meenavar	மீனார்வரர்
meenavargalukku	மீனார்களுக்கு
meenavarkalukku	மீனார்களுக்கு
meenvarkalukku	மீன்வர்களுக்கு
pidikka	பிடிக்காக்க்க்காக்க்க
pitikka	பிடிக்க
meengalin	மீன்களின்
meenkalin	மீன்களினி
meengalukku	மீங்களுக்கு
meenkalukku	மீன்களுக்கு
meengalaiyum	மீன்களையும்
meenkalaiyum	மீன்களையும்
meenkalayum	மீன்களையும்
mugaththuvaaraththil	முகத்துவாரத்தில்
mukaththuvaaraththil	முகத்துவாறத்தில்
mugaththuvaaram	முகத்துவாரம்
mukaththuvaaram	முகத்துவாரம்
mugamaaga	முகமாக
mugamaaka	முகமாக
mukamaaka	முகமாக
mugamaagavum	முகமாகவும்
mugamaakavum	முகமாகவும்
mukamaakavum	முகமாகவும்
makammathu	மகம்மது
mohammedhu	மகம்மது
mugammathu	முகம்மது
muhammad	முகம்மாதாட்டம்
mukammathu	முகம்மது
mugaitheen	சுகைதீனின்
muhaideen	சுகைதின்
muhaitheen	சுகைத்னீன்
mukaitheen	முகைதீனீன்
mukthaa	ஊக்கா
mukkthi	சுக்
mukthi	சுக்தி
muchuleem	முசுலிம்
musleem	முசுலிமியம்
muslim	முசுலிமிம்
musuleem	முசுலிமீம்
musulim	முசுலிம்
mudindhdhathu	முடிந்தது
mudindthathu	முடிந்தது
mudinthathu	முடிந்தது
mudindhdhathum	முடிந்ததும்
mudindthathum	முடிந்ததும்
mudinthathum	முடிந்ததும்
mudindhdhapoathu	முடிந்தபோது
mudinthapoathu	முடிந்தபோது
mudindhdhavudan	முடிந்தவுடன்
mudinthavudan	முடிந்தவுடன்
mudindhdhaalum	முடிந்தாலும்
mudinthaalum	முடிந்தாலும்
mudindhdhaal	முடிந்தால்
mudinthaal	முடிந்தால்
mudippu	முடிப்புப்ப்ப்ப்ப்ப்ப்ப்ப்ப்ப்ப்
mudiyudai	முடியுடை
mudivirku	முடிவிற்கு
mudivilaa	முடிவிலா
mudivil	முடிவில்
muthaliya	முதலிய
muthaliyana	முதலியன
muthaliyanavum	முதலியனவும்
muthaliyavargal	முதலியவர்கள்
muthaliyavarkal	முதலியவர்கள்
muthaliyoar	முதலியோர்
muthaliyor	முதலியூர்
muththa	நியுத்த்த்து
muththai	முத்தை
muthaiya	முதையாயை
muththaiya	முத்தையாயை
muththaiyaa	முத்தையாயாய்யா
mundhi	நுந்தி
munthi	நுந்தி
munthik	முந்திக்கிக்கிக்கிக்கிக்கி
munanikku	முனநிக்குக்கு
munnanikku	முன்னனிக்குக்கு
munnaniyin	முன்னனியின்
munnaniyai	முன்னனியை
munnuthaaranamaaga	முன்னுதாரணமாக
munnuthaaranamaaka	முன்னுதாரணாக
munnedukka	முன்னெடுக்க்க
munnetukka	முன்னெடுக்க்க
munmaadhiri	முன்மாதிரி
munmaathiri	முன்மாதிரி
munmadiri	முன்மடிரிரி
munmaathiriyai	முன்மாதிரியை
munmadiriyai	முன்மடிரியை
munmathiriyai	முன்மதிரியை
munvaiththathu	முன்வைத்தது
munvaiththaar	முன்வைத்தார்
munvaiththu	முன்வைத்து
munvaiththullathu	முன்வைத்துள்ளது
mupparimaana	முப்பரிமான
mummuramaaga	மும்முறமாக
mummuramaaha	மும்முறமாக
mummuramaaka	மும்முரமாக
muyandranar	முயன்றனரர்
muyanranar	மயன்றனர்
muyantranar	முயன்றனர்
muyandrapoathu	முயன்றபோது
muyanrapoathu	முயன்றபோது
muyantrapoathu	முயன்றபோது
muyandraar	முயன்றாரார்
muyanraar	முயன்றாறார்
muyantraar	முயன்றாரார்
muyandraal	முயன்றால்
muyanraal	முயன்றால்
muyantraal	முயன்றால்
muyanrum	முயன்றும்
muyantrum	முயன்றும்
muraimaigalai	முறைமைகளை
muraimaikalai	முறைமைகளை
muraimaigal	முறைமைகள்
muraimaikal	முறைமைகள்
muraimaikku	முறைமைக்கு
muraimaiyai	முறைமையை
murpattathu	முற்பட்டது
murpattaar	முற்பட்டார்
mulangka	முழங்க
muzhangka	முழங்க
mulavu	சுழவு
muzhavu	ஞுவவு
mauhamad	மௌகமதமாதாத
mauhammad	மௌகம்மடமடத்
mauuhammad	மௌகம்மட்மடடடத்
mohamad	மோகமதமாதாதாதாத
mohammad	மோகம்மடம்
muhammad	முகம்மாதாட்டம்
muhammat	முகம்மடமட்டம்
muhammath	முகம்மதத
muhammed	முஹம்மெடம்
mookku	ஞாக்கு
mookkuk	மூக்குக்குக்
mookkum	மூக்கும்
moondrarai	மூன்றாை
moonrarai	மூன்றரை
moondraaga	மூன்றாக
moonraaga	மூன்றாக
moondraavadhum	மூன்றாவதும்
moondraavathum	மூன்றாவதும்
moondrilirundhu	மூன்றிலிருந்து
moondrilirunththu	மூன்றிலிருந்து
moondrilirunthu	மூன்றிலிருந்து
moondrae	மூன்றேரேே
moondre	மூன்றெர்
moontrae	வுன்றேரேே
moorthi	மர்தி
moorththi	ஊர்த்தி
murthi	முத்தி
moorthigal	மூர்திகள்
moorththigal	மூர்த்திகள்
moorththikal	மூர்த்திகள்
murthigal	முர்திகள்
moorthiyaaga	மூர்தியாக
moorththiyaaga	மூர்த்தியாக
murthiyaaga	முத்தியாக
moolakkoorugal	மூலக்கூறுகள்
moolakkoorukal	மூலக்கூறுகள்
moolamoa	மூலமோமோ
moolashthaanaththil	மூலசாத்தானத்தில்
moolasthaanaththil	மூலசத்தானத்தில்
moolgadikkappatta	மூல்கடிக்கப்பட்ட
moolzhgadikkappatta	மூழ்காட்கடிக்கப்பட்ட
moozhgadikkappatta	மூழ்கடிக்கப்பட்ட
metti	ட்டிட்டி
maethyoo	மேத்தூயோ
mathew	்வேவ்வே
maeni	மேனினின்மணு
maeniyai	மேனியை
meniyai	மெனியைை
maenilai	மேனிலை
maeman	மேமந்தனம்மான்ம
mamon	மேனோனம்னம்
meman	மேமந்தனம்மான்மாம்
maembaalap	மேம்பாளப்பப்பல்
maempaalap	மேம்பாலப்பப்பப்பல்ப்
meampaalap	மேம்பாலப்பப்பல்ப்
maembaalam	மேம்பாலம்
maempaalam	மேம்பாலம்
meampaalam	மேம்பாலம்
maelavai	மேலவை
maelavaiyil	மேலவையில்
maelmaruvaththoor	மேல்மறுவத்தூர்
melmaruvathur	மேல்மறுவதுற்
maicroasaapt	மைக்ரோசாப்டாப்டாப்
maicroosooft	மைக்ரூச்டூப்ட்
maicrosoft	மைக்ரோபப்டோப்பூட்டுப்
maicrosopht	மைக்கோபோப்ட்த்
mecrosoft	மிக்ரோபாோப்டோப்டூப்டோப்
microosooft	மிக்ரூப்போப்டு
microosooftt	மிக்ரூப்ட்ப்ட்ட்ட்ட்ட்
microowsooft	மிகூரோப்போப்டோப்டு
microsaaft	மிற்ரோசாப்டப்பாத்பா்பட்டைப்
microsoft	மிகூராப்டூப்ட்
microsoftt	மிக்ரொப்தரப்ட்ட்ட்ட்ட்ட்ட்ட்ட்ட்
microsopht	மிக்ரோப்புப்ட்
microsophtt	மிக்ரோப்பட்ட்ட்ட்ட்ட்ட்ட்ட்ட்ட்ட
microvsoft	மிக்ரோஸ்வோப்டோப்புட்டு
microwsoft	மிக்ராப்போப்பூட்
microwsopht	மிக்ரொழொப்போப்ட்
maiyamaaga	மையமாக
maiyamaaka	மையமாக
myyamaaka	மையமாக
maiyamaagak	மையமாககககககககககககககககககககககககககக
maiyamaakak	மையமாககககககககககககககககககககககககககக
myyamaakak	மையமாகககககககக
maiyamaagavum	மையமாகவும்
maiyamaakavum	மையமாகவும்
myyamaakavum	மையமாகவும்
mochchai	மெச்சை
moraaccoa	மொராக்கோ
moraakkao	மொராக்கூக
moraakkoa	மொராக்கோ
morocco	மோரோக்கோ
moasae	மேசேஸ்
mosae	மோசேசேஸ்
yaabbilakkanam	யாப்பிலக்கன்ம்
yaappilakkanam	எப்பிலக்கனமம்
yaaraavathu	ஞாராவது
yaaridamum	ஞாரிடமும்
yaaritamum	யாரிடமும்
yaaridam	யாரிடம்
yaaritam	யாரிடம்
yaaaraenum	யாதேரும்
yaaraenum	யாரேனும்
unesco	யுன்சனஸ்கோரோ
yunesco	யூனேஷ்கோகோகோகோோ
yuneskoa	யுனேஷ்கோ
unescovin	உணேசோவின்
yunescoovin	இய்செஸ்வோனின்
yuneskoavin	யுனேஸ்கோவின்
iooe	யூ
iue	ஈயியூ
iuee	யூய்யே
yooe	வியோ
yue	யூயுயுயுயு
yuee	யுயு
yuii	ூயி
yuu	ூயு
yuue	யூயுயுயுயுயு
yuuee	யுயேய்
yooth	யூத்தியோத்த
youth	யூத்யூத்
ioore	ஈய்ரி
iuri	யூரி
uree	ோரி
urii	நுரி
uuree	யுரே
yoore	யோர்
yoori	யூரி
youri	யூரி
yure	யுர்ரே
yuri	யுரியி
yuuri	யுரி
uric	நிரிச்சி
yoorik	ஆய்
yourik	ஆசிரிகிரிக்கி
yellaam	எல்லாம்
yoagaththin	யோகத்தின்
yoakaththin	யோகத்தின்
yookaththin	யோக்கத்தின்
yoagan	லாகனனன்
yoakan	யூகன்கன்னன்
yogan	யோகன்னனனனனனனன்னனனனனன்னன்னன்னனன்ன
yookan	யூகன்னனன்
yoagam	யோகமம்
yoakam	யேகமம்ம்
yogam	யோகம்ம்ம்
yookam	யூகம்ம்
yoakkiyamaana	ஆய்கியமான
yokkiyamaana	ஞாக்கியமான
yookkiyamaana	யோக்கியமான
yoasanaigal	அயசசைகள்
yoasanaikal	யோசனைகள்
yoosanaikal	யூசனைகள்
yoasanaikku	ஆசசனைக்கு
yoosanaikku	ஞோசனைக்கு
rasa	ரசஷ
railgal	ரரிகள்கள்
railhal	ரயிலலலலலலலலலலலலலலலலலலலலலலலலலலலலல
railkal	ரர்கள்ளல்
raiylgal	ரயில்கள்
raiylhal	ரயில்லல்
raiylkal	ரயில்கள்
rayilgal	ரயில்கள்
rayilkal	ரயில்கள்
rashyan	ரஷ்யன்
rassian	ருசன்னியன்
russian	ரஷியன்ன்யன்
ragman	ரர்மனன்
rahmaan	ரர்மான்ன்
rahman	ரரமண்மான்்தன்
rehhman	ரேஷ்மானன்
rehmaan	ரேம்மான்
rehman	ரேம்மான்னன்
rehmann	சிம்மான்ன்னண்ணன்
raajaraajanin	இராஜராஜனினின்
rajarajanin	இராஜராஜனினின்
raajaraajan	ராஜராஜன்
rajarajan	ராஜராஜனனன்
raanuva	நினுவுவ்
raanuvath	ரராணுவதததததததததததததததததததததததததத
raanuvaththirku	ராணுவத்திற்கு
raanuvaththil	ராணுவத்தில்
raanuvaththai	ராணுவத்தை
raamachchanthiran	ரராம்சந்திரன்
ramachandran	ரமமசன்றன
ramachchandiran	ரரசம்சாந்திரன
ramachchandran	ரமம்சந்திரன்
raam	ராம்
raamaa	ரராமாாமாமாமாமமாமாமா
ram	ாாம்ம்
rama	ரமமமமமாம
raamaayanam	ரராமாயணமம்
raamayanam	ரராமயமம்
ramayanam	ரமணயமனம்
ring	ங்கிர்
ringk	்க்
rink	கின்க்
rings	சி
reserve	தேசர்வேஸ்வே
risarv	ரிஷர்வர்வர்வர்
reeshi	ஷேஷ்சி
reesi	ஷேசிசிசிசி
reesii	தீசி
reshii	த்சி
resii	ாசிசி
riishi	ரிஷி
riisi	திசிசி
riisii	தீரிசி
rishi	திஷி
rishii	தீஷி
risi	திசிசிசிசிசி
risii	த்ரிஷி
rishigal	ரிஷிகள்
rishikal	ரிஷிகள்
reethiyilum	ரீதியிலும்
reethiyil	ரீதியில்
roopavaahini	தோப்பாவினின்
roopavahini	தோப்பவாினினின்
rupavahini	துபவதியினி
rupavauhini	ருபவுகினின்
racklaa	ரர்க்கிலா
raeklaa	ரேகாளா
rekla	கேர்லில்
raench	சேந்ச்சார்ச்ச்ச்ச்ச்ச்சுர்ன்ச்ச்
raenjch	்ச்ச்ச்ச்ச்ச்ச்ச்ச்ச்ச்ச்ச்ச்ச்ச
radaar	ரடாராராராராராரார்
radar	ரடராாார்
radarr	கேடர்
raedaar	ரேடாரார்
redar	கேராடர்
reedar	நீட்ராரரர்
raendam	ரரண்டம்மம்ம்
raentam	ரரண்டம்
random	ரண்டோம்
rendaam	ரண்டாம்
raaend	நாந்த
raand	ந்த்
rand	ந்தரண்ட்ட்்
reend	ந்ட்
rend	நிண்ட்
roadu	மோடு
roam	ைம்மோரோ
rome	ரோமிம்
roavar	ரோவரர்
roaver	கோவர்
roawer	கோவேர்
rooaver	கூவரேர்
roovar	ரூவர்
roover	கூவர்
roower	கூவர்
rovar	ராவர்
rover	கோவர்
rowar	ரோவார்வர்
rower	கோவர்
lachith	லச்சித்தித்தித்த
lacith	லெக்க்்
lasith	லாசித்தித்தித்தித்
latchanam	லட்சனம்
lakchhami	சக்சகமிி
lakshmee	லக்சீஸ்
lakshmi	லக்சிஸ்மி
laksmee	லக்சீம்மி
laksmii	லக்ஸிமீ
laqchhami	சாக்சாமி
laqsmee	லக்ச்மேஷி
laqsmi	லாக்ஸ்மி
lakshimiyin	லக்சிமியின்
lakshumiyin	இக்சும்யின்
latchumiyin	இடக்சுமியின்
latsumiyin	இட்சுமியின்
laddu	ல்டது
lattu	லாட்டு
landanil	லண்டனில்
londonil	லாட்னோலில்
laththeen	லத்தினின்
latiin	லலி
latiina	லீட்டினான
latin	லாட்டின்
lattiin	லல்்
letan	லாட்டன்்
leten	லெட்டன்
letiin	லத்தினினி
letin	லெட்டினின்
lalithaa	லலித்தாத்
laagic	லாகிகிசிசிக்சிக்சிச்
laajic	லாஜிசிச்சிக்சிச்சிச்சிச்சிக்சிச்
logic	லூகிச்சிக்ஸிக்சிஸ்கிக்சிச்ஸ்கிச்
laabaththai	லாபத்தை
laapaththai	லாபத்தை
linda	நிங்ட
lindaa	ஞில்தா
linaks	லினாஸ்ஸ்ஸ்ஸாஸ்ஸ்ஸாஸ்ஸ்ஸ்
linux	கின்்
livarpool	லிவர்போல்ல்
livarpuul	லிவ்பால்
liverpool	லிவர்போல்லூல்
liverpul	லிவர்ப்புள்ளுள்ள
liwerpool	லிவர்போல்லூல்
leaguein	லேசுஜைன்
leakin	லேகினின்
leakkin	லேக்கின்
leekin	லிகினின்
loodhana	ஞாதனான
loodhiaanaa	லூதியானா
loodhiana	லூதியானான
ludhana	ஞலுநானன
ludheeana	நூதீயானா
ludheena	நூதீனா
ludhiaanaa	லூதியானா
ludhiana	லூதியனன
ludhiiana	லூதியனனான
luudheeana	நுதீயான
luudhiana	லூதியனன
luutiyana	லுட்டியனன
lakshmi	லக்சிஸ்மி
letchumi	லெட்சுமி
letshumi	செல்சுமிமி
laechana	லேசனனன
laesaana	லேசான
laenaa	லெனா
laneaa	லனாயா
loagiyaa	லோகியாயா
loakiyaa	லூகியாயா
vaguththa	வகுத்த்த்த
vakuththa	வகுத்த்த்த்த்த
vaguththadhu	வகுத்தது
vaguththathu	வகுத்தது
vakuththathu	வகுத்தது
vaguththal	வகுத்தல்
vakuththal	வகுத்தல்
vaguththaar	வகுத்தார்
vakuththaar	வகுத்தார்
vaguththaal	வகுத்தால்லால்
vakuththaal	வகுத்தால்
vakkeel	க்கேலில்
vangadhaesaththin	வங்கதேசத்தின்
vangathaesaththin	வங்கதேசத்தின்
vangkadhaesaththin	வங்கதேசத்தின்
vangadhaesam	வங்கதேசம்
vangathaesam	வங்கதேசம்
vangkadhaesam	வங்கதேசம்
vasiththanar	வசித்தனர்
vanchi	வஞ்சிசி
vanji	வஞ்சி
vansi	ன்சி
vadanaattil	வடனாட்டில்
vadapuram	வடபுரம்
vadamaerkil	வடமேற்கில்
vatamaerkil	வடமேற்கில்
vadikaal	வடிகாள்
vadikal	வடிகள்
vadikkappatta	வடிக்கப்பட்ட
vadikkappattathu	வடிக்கப்பட்டது
vattiyai	வட்டியைை
vanigarkalin	வணிகர்களின்
vanikarkalin	வணிகர்களின்
vanigarkalum	வணிகர்களும்
vanikarkalum	வணிகர்களும்
vanigargal	வணிகர்கள்
vanigarkal	வணிகர்கள்
vanikarkal	வணிகர்கள்
vadham	வதம்மகம்ம்
vatham	வதமம்
wadham	வதமம்
watham	ம்மம்
vandhanar	வந்தனர்
vanthanar	வந்தனரர்
vanththanar	வந்தனர்
vanthiyathevan	வந்தியதேவன்
vanthiyaththaevan	வந்தியத்தேவன்
vanthiyaththevan	வந்தியத்தஓவன்
vanpunarvu	வன்புணர்வு
vamsaththil	வம்சத்தில்
vamsaththai	வம்சத்தை
vayathin	வயதினின்
varadhan	வரதானந்தனனன்
varathan	வரதானந்தன்
varadham	வரத
varatham	வரதமம்
varappoagum	வரப்போகும்
varappoakum	வரப்போகும்
varalaam	வரலாம்
varalaattruch	வரளாற்றுச்சுச்சுச்சுச்சுச்சுச்
varalaattruth	வரளாற்றுத்து
varavaal	வரவால்
varavirukkum	வரவிருக்கும்
varaaga	வராகாகாகப்
varaaka	வராகாக
varaga	வரககர
vari	வேரி
varigalai	வரிகளை
varikalai	வரிகளை
varigal	வரிகள்
varikal	வரிகள
variyil	வரியில்
variyai	வரியைை
varudi	வருடி
varuvaai	வருவாய்
varuvaay	வருவாய்யாய்
varuvaaith	வருவாத்தைத்
varuvaayth	வருவாய்த்
varuvaith	வருவைத்
vruvaayth	விவுவாத்த்த்
varaikooda	வரைகோடோடுட
varaikoodaa	வரைகோடாடாட்டா
valasai	வேசை
valimaiyaana	வலிமையான
vallarasu	வள்ளராசுறு
valaththaiyum	வளத்தையும்
valaigutaa	வலைகுடாடாட்டாட்
valaikudaa	வலைகுடாடாடாடாடாடாடாடாடாடாடாடாடாட
valaikutaa	வலைகுடாட்டாட்டா
valaigutaavil	வலைகுடாவால்
valaikudaavil	வலைக்குடாவில்
valaikutaavil	வலைகுடாவில்
valakku	வழக்கு
vazhakku	வழக்கு
vicarikka	விசரிக்க
visaarikka	விசாரிக்க
visarikka	விசரிக்க
valakkugalil	வழக்குகளில்
valakkukalil	வழக்குகளில்
vazhakkukalil	வழக்குகளில்
valakkugalukku	வழக்குகளுக்கு
valakkukalukku	வழக்குகளுக்கு
vazhakkukalukku	வழக்குகளுக்கு
valakkugalum	வழக்குகளும்
valakkukalum	வழக்குகளும்
vazhakkukalum	வழக்குகளும்
valakkugalaiyum	வழக்குகளையும்
valakkukalaiyum	வழக்குகளையும்
vazhakkukalaiyum	வழக்குகளையும்
valakkup	வழக்குப்புப்
vazhakkup	வழக்குப்புப்
valakkurai	வழக்குறை
vazhakkurai	வழக்குறை
valangappadaamal	வழங்கப்படாமல்
vazhangappadaamal	வழங்கப்படாமல்
vazhanggappadaamal	வழங்கப்படாமல்
valangappaduvathu	வழங்கப்படுவது
valangkappaduvathu	வழங்கப்படுவது
vazhanggappaduvathu	வழங்கப்படுவது
vazhangkappaduvathu	வழங்கப்படுவது
valangal	வழங்கள்
valangkal	வழங்கள்
vazhangkal	வழங்கள்
valangkunar	வழங்குணர்
valankunar	வழங்குனர்
vazhanggunar	வழங்குணர்
vazhangkunar	வழங்குணர்
vazhankunar	வழங்குணரணரர்
valangkuvathutan	வழங்குவதுடன்
valanguvathudan	வழங்குவதுடன்
vazhangkuvathudan	வழங்குவதுடன்
vazhanguvathudan	வழங்குவதுடன்
valangkuvathai	வழங்குவதை
valanguvathai	வழங்குவதை
vazhangkuvathai	வழங்குவதை
vazhanguvathai	வழங்குவதை
valigaattu	வழிகாட்டு
valikaattu	வழிகாட்டு
vazhigaattu	வழிகாட்டு
vazhikaattu	வழிகாட்டு
valikaattum	வழிகாட்டும்
vazhigaattum	வழிகாட்டும்
vazhikaattum	வழிகாட்டும்
valiththoanral	வழித்தோன்றல்
vazhiththoantral	வழித்தோன்றல்
valiththoanralkal	வழித்தோன்றல்கள்
vazhithoantralgal	வழிதோன்றல்கள்
vazhiththoantralgal	வழித்தோன்றல்கள்
valinadaththi	வழினடத்தி
vazhinadaththi	வழினடத்தி
valinadaththinaar	வழினடத்தினார்
vazhinadaththinaar	வழினடத்தினார்
valinadaththum	வழினடத்தும்
vazhinadaththum	வழினடத்தும்
valukku	வழுக்கு
vazhukku	வழுக்கு
vavuniya	வவுனியாயையையை
vavuniyaa	வேவுயானாயா
vaagananggalin	வாகனங்களின்
vaaganangkalin	வாகனங்களின்
vaakanangkalin	வாகனங்களின்
vaagananggalukku	வாகனங்களுக்கு
vaaganangkalukku	வாகனங்களுக்கு
vaakanangkalukku	வாகனங்களுக்கு
vaaganagkalaik	வாகணக்களைக்
vaagananggalaik	வாகனங்களைக்
vaakanangkalaik	வாகனங்களைக்
vaagananggalaiyum	வாகனங்களையும்
vaaganangkalaiyum	வாகனங்களையும்
vaakanangkalaiyum	வாகனங்களையும்
vaaganaththai	வாகனத்தை
vaakanaththai	வாகனத்தை
vaaganamaaga	வாகனமாக
vaaganamaga	வாகனமாககக
vaaganamaka	வாகனமாக
vaakanamaaka	வாகனமாக
vaakanamaga	வாகனமாக
vaakanamaka	வாகனமாக
vaaganam	வாகனம்
vaakanam	வாகனம்
paesalaam	பேசலாம்
pecalam	பேசலம்
pesalaam	பேசலாம்
vaangappadum	வாங்கப்படும்
vaanggappadum	வாங்கப்படும்
vaangkappadum	வாங்கப்படும்
vaangappattu	வழிங்கப்பட்டு
vaanggappattu	வழிங்கப்பட்டு
vaangkappattu	வழிங்கப்பட்டு
vaangavum	வங்கவும்
vaanggavum	வர்க்கவும்
vaangguthal	வாங்குதல்
vaangkuthal	வாங்குதல்
boadhum	போதும்ம்
poadhum	னோமும்
poathum	போதும்பும்
vaanggum	வங்கும்
vaangkum	வங்கும்
vaangum	வங்கும்
vaasippathil	வாசிப்பதில்
vaasippathu	வாசிப்பது
vaasippavar	வாசிப்பவர்
vaadiya	ஊத்தியாய
vaater	வார்ட்டர்
vatar	நாவ்
vater	என்ற்
vaterr	வத்்ற்்
veter	வேட்டர்
vouter	வட்டர்
waatar	வாட்ரர்
waater	த்தர்
waeter	கத்தர்
watar	வேரா
watarr	வாட்டர்்ர்
water	க்்
waterr	வதேர்
weter	கத்தர்
weterr	வத்தர்
woutar	வௌதர்ரர்
wouter	ட்டர்
wouuter	ட்டர்
vaattara	வாட்டர
vaatters	வாட்டர்ஸ்்ஸ்்
waters	வாதர்ச்சர்ஸ்்
vaathittathu	வாதிட்டது
vaathittaar	வாதிட்டார்
vaathittu	வாதிட்டுட்டு
vaayilaagavum	வாயிலாகவும்
vaayilaakavum	வாயிலாகவும்
vaalin	லோனினின்
vaazhvathu	வாழ்வது
vaalvar	வாழ்வரர்
vaazhvar	வாழ்வரர்
vaazhvilirundthu	வாழ்விழிருந்து
vaazhvilirunththu	வாழ்விழிருந்து
vaazhvilirunthu	வாழ்விழிருந்து
vaalvu	வாழ்வு
vaazhvu	வாழ்வு
vaalvum	வாழ்வும்
vaazhvae	வாழ்வே
vaazhvum	வாழ்வும்ம்
vaasthu	த்து
vigaaraigal	விகாரைகள்
viharaigal	விகரைகள்
vikaaraigal	விகாரைகள்
vikiraman	விகிரமாமன்
vikkiraman	விக்கிறமணமான்
vikraman	விக்ரமானன்
vichaariththa	விசாரித்த
visaariththa	விசாரித்த
vichaeshamaana	விசேசமான
visaeshamaana	விசேஷமான
vichai	விசைகை
visai	விஷை
vichaikalai	விசைகளை
visaigalai	விசைகளை
visaikalai	விசைகளை
visaiyin	விசையின்
visaiyudan	விசையுடன்
vinchi	வின்சி
vinjchi	வின்சி
vinchiya	வின்சியிய
vinjchiya	விஞ்சிய்யி
vidayanggalai	விடையங்களை
vidayangkalai	விடையங்களை
vitayangkalai	விடைகளைகளை
vidayaththai	விடைத்தை
vitayaththai	விடையத்தை
vidayamaaka	விடையாாக
vidayanmaaga	விடையாமாக
vitayamaaga	விடையமாக
vidayam	விடையம்
vitayam	விடையம்
vittaal	விட்டால்
vittaen	விட்டேன்
vidhikka	விதிக்காக்காக்க
vithikka	விதிக்காக்காக
vithikkavillai	விதிக்கவில்லை
vidhdhiyaa	வித்தியாய்
vidhya	வித்யய்யாய்யாய்யாய்யாய்யாய்யாய்ய
viththiyaa	வித்தியாய்
viththiyaachaththil	வித்தியாதத்தில்
viththiyaasaththil	வித்தியாசத்தில்
viththiyaachaththai	வித்தியாத்தை
viththiyaasaththai	வித்தியாதத்தை
viththiyaachap	வித்தியாசப்
viththiyaasap	வித்தியாசப்பப்
viththiyaaamaaga	வித்தியாமாக
viththiyaachamaaka	வித்தியாகமாக
viththiyaasamaaga	வித்தியாசமாக
viththiyaasam	வித்தியாசம்
vineedh	விநீதேதி
vineeth	வினீத்திய்த்
vibaththin	விபத்தின்
vipaththin	விபத்தின்
vibaththil	விபத்தில்
vipaththil	விபத்தில்
vimarsiththaar	விமர்சித்தார்
vimarsiththullaar	விமர்சித்துள்ளார்
vimaanangalin	விமானங்களின்
vimaananggalin	விமானங்களின்
vimaanangalum	விமானங்களும்
vimaananggalum	விமானங்களும்
vimaananggal	விமானங்கள்
vimaanankal	விமானங்கள்
viyantha	வியந்தந்த
viyanththa	வியந்த்த்த்தந்து
viyanththu	வியந்து
viyanthu	வியந்து
viyaabaarigalin	வியாபாரிகளின்
viyaapaarigalin	வியாபாரிகளின்
viratha	விரதாதாதாத
virathangal	விரதங்கள்
virathanggal	விரதங்கள்
virathangkal	விரதங்கள்
viradham	விரதம்
viratham	விரதம்
virivaaga	விரிவாக
virivaagath	விரிவாகத்
virivuraigal	விரிவுறைகள்
virumbaatha	விரும்பாத்தாத
virumbaathu	விரும்பாது
virpathu	விற்பது
vitrtrathu	விற்றது
vittradhu	விற்றது
vittrathu	விற்றது
vitrtral	விற்றலளாள்லல்ல்
vittral	விற்றலள்
vitrtraar	விற்றாரார்
vittraar	விற்றார்
viliam	விளியமமமமமமமமமமமமமமமமமமமமமமமமமமம
viliiam	விளியமமம்
viliyam	விளியம்
villiam	விள்ளியம்மமமமம்
villiyam	விள்ளியம்மம்
wiliam	ஈய்லாமியமமம்
wiliiam	வில்லாமியம்
wiliyam	வில்லியம்மம்
william	வில்லியம்மமமமமமமமமமமமமமமமமமமமமமம
villiams	விள்ளியம்சம்ஸ்
villiyams	விள்ளியம்சம்ஸ்ஸ்
wiliams	வில்லியம்ஸ்ஸ்்
williams	வில்லியம்சாஸ்்
villaigal	விளைகள்
villaikal	விளைகள்
villaiyum	விள்ளையும்
vilaadimir	விளாடிமிரிர்
viladimir	விளாடிமிரீர்
vlaadimir	விளாடிமிரிர்
vlademar	விளாடமார்
vlademer	விளாமரைாரர்
vladimir	விளாடிமீர்
vladimirr	விளாடிமிர்
vladymyr	விளாடிமிர்
wlademer	வெலாடமமர்
wladimir	விளாடிமிரிர்
wladimirr	லுகாடிமிர்
wladymyr	வெளாடிமிர்
vilimbugal	விளிம்புகள்
vilimbukal	விளிம்புகள்
vilimpugal	விளிம்புகள்
vilimpukal	விளிம்புகள்
vilaiyaada	விளையாட
vilaiyaadappadum	விளையாடப்படும்
vilaiyaadavillai	விளையாடவில்லை
vilaiyaadudhal	விளையாடுதலுள்
vilaiyaaduthal	விளையாடுதல்
vilaiyaattaagavum	விளையாட்டாகவும்
vilaiyaattaakavum	விளையாட்டாகவும்
villupuram	விளுபுறம்
viluppuram	விலுப்புறம்
vilupuram	விழுபுரமமம்
vizhuppuram	விழுப்புறமம்
vivariththaar	விவரித்தார்
vivariththullaar	விவரித்துள்ளார்
vishaagaa	விஷாகா
vishaakaa	விஷாகா
vishaka	விஷாகாகக்
veesappatta	வீசப்பட்ட
veechith	ிசித்தித்த்
veesith	திதுத்தித்தித்தி
veechina	வீசினினான
veesina	வீசினானன
veechuthal	வீசுதல்
veesuthal	வீசுதலலல்
veechuvatharku	வீசுவதற்கு
veesuvatharku	வீசுவதற்கு
veetirkuch	வீடிற்குச்ச்ச்சுச்சு
veettirguch	வீட்டிற்குச்சச்
veettirkuch	வீட்டிற்குச்சுச்
veettilae	வீட்டிலே
veeraraaga	வீரராக
veeraraaka	வீரராக
veetrirukkum	வீற்றிக்கும்
veetrtrirukkum	வீற்றிருக்கும்
veettrirukkum	வீற்றிருக்கும்
veel	வீளிலி
veil	வில்வில்லி
viil	வில்லி
weiil	ூே
weil	வெயில்
wheel	லூல்
veelchchikkum	வீழ்ச்சிக்கும்
veerzhchchikkum	வீர்ச்சிக்கும்
veezhchchikkum	வீழ்ச்சிக்கும்
veelchchiyin	வீழ்ச்சியின்
veezhchchiyin	வீழ்ச்சியின்
veelchchiyilirunththu	வீழ்ச்சியிலிருந்து
veezhchchiyilirunththu	வீழ்ச்சியிலிருந்து
veezhchchiyilirunthu	வீழ்ச்சியிலிருந்து
veelchchiyum	வீழ்ச்சியும்
veezhchchiyum	வீழ்ச்சியும்
veelnththathu	வீழ்ந்தது
veezhnthathu	வீழ்ந்தது
vedikkach	வெடிக்கச்சச்சைச்சைச்சைச்
veppaththin	வெப்பத்தின்
veppaththaith	வெப்பத்தைத்தைத்
veppaththaiyum	வெப்பத்தையும்
veppap	வெப்பப்பப்பப்ப
veppamaaga	வெப்பமாக
veppamaaka	வெப்பமாக
veruththa	வெறுத்த
veruththaar	வெறுத்தார்
verumai	வெறுமைை
verumaiyaaga	வெருமையாக
verumaiyaaka	வெறுமையாக
vetrikaramaaka	வெற்றிகராக
vetrtrigaramaaga	வெற்றிகரமாக
vetrtrikaramaaka	வெற்றிகரமாக
vetrida	வெற்றித
vetrtrida	ஊற்றிருடிடத
vetrtrita	வெற்றிட்டாட்ட
vettrida	வெற்றிடிட
vetridaththil	வெற்றிடத்தில்
vetrtridaththil	வெற்றிடத்தில்
vetrtritaththil	வெற்றிடத்தில்
vettridaththil	வெற்றிடத்தில்
vetrtridaththai	வெற்றிடத்தை
vetrtritaththai	வெற்றிடத்தை
vettridaththai	வெற்றிடத்தை
vetrtridam	வெற்றிடம்
vetrtritam	வெற்றிடமடம்
vettridam	வெற்றிடம்
vaelsh	வேல்ஸ்ஸ்
vels	வெள்ஸ்ஸ்ஸ்
velsh	வேல்ஸ்ல்ஸ்ஸ்ஷ்
veyls	ச்ச்ஸ்ல்
weils	ச்சுலில்
wells	ல்சில்ல்சல்
wellsh	வெல்ச்ச்ச்
wels	ச்சில்ஸ்ல்
welsh	ச்ச்ஸ்
weyls	ல்ச்சல்ல்ல்ஸ்ல்
weylsh	்ச்ச்
velip	லீப்பிப்பிப்பிப்பிப்பிப்பிப்பிப்
velippadaiyaanadhu	வெளிப்படையானது
velippadaiyaanathu	வெளிப்படையானது
velippuram	வெளிப்புரமம்
veliyidappattana	வெளியிடப்பட்டன
vaegam	வேகம்மம்ம்
vaekam	வேகம்ம்
vaedhak	வேதகாககாக்காக்காகவாக்கதாக்கவாக்க
vaethak	வேதககககககக்
vedeec	வெடீச்
vedic	வெடிக்சிக்
vediic	வீடிச்சி
vedik	வடிக்
vediq	வீடிக்
veedeec	வீடேசீக்ஸ்
veedic	வீடிக்சி
veedik	வீடிக்
veetak	வீடாகக்ககககககககககககககககககககககககக
wedeec	விடீக்ஷீக்
wedic	தெடிச்சிக்ஸிக்ஸிக்ஸிக்ஸி
wedik	ஸிகிடிக்
vaedhangkalil	வேதங்களில்
vaethangalil	வேதங்களில்
vaethangkalil	வேதங்களில்
vaedhaththin	வேதத்தின்
vaethaththin	வேதத்தின்
vaedhaththil	வேதத்தில்
vaethaththil	வேதத்தில்
vaedhaththai	வேதத்தை
vaethaththai	வேதத்தை
vaedhaalam	வேதாளம்
vaethaalam	வேதாலமம்
vedhaalam	வேதாளம்
vaedhi	வேதி
vaethi	வேதி
vedhi	வேதி
vaedhipporulkal	வேதிப்பொருள்கள்
vaethipporutkal	வேதிப்பொருட்கள்
vaedhiyar	வேதியரர்
vaethiyar	வேதியரர்
vaenae	வேணே
vanae	வனேணே
vae	சுவவவாவே
vaei	வேய்
vaey	ஈசவாய்வே
vai	வை
vay	சாய்வாய்வா
veey	வியே
wae	வியேவாவேவுவ்வ்விவ்விவ்வுவ்வே
waee	ஈ
wai	வை
way	சூயாவே
vaerudan	வேறுடனன்
vaerutan	வேறுடன்ன
vaerldu	வேர்ல்டு
world	ை
vaeraaga	வேறாக
vaeraaka	வேறாக
vaeroru	வேறு
vaeroruvan	வேறோவனுவன்
vaeroruvar	வேறோரவர்வர்
vaelunaachchiyaar	வேலுநாச்சியார்
velunachiyar	வெளுநசியர்
vaelai	வளை
vaelaigalin	வேலைகளின்
vaelaikalin	வேலைகளினின்
vaelaigalum	வேலைகளும்
vaelaikalum	வேலைகளும்
vaelaigalai	வேலைகளை
vaelaikalai	வேலைகளை
vaelaik	ைமைக்
vaelaikkaana	வேலைக்கான
vaelaikkup	வேளைக்குப்புப்
vaelaikkum	வேளைக்கும்
vaelaich	வேளைச்சைசைசைசை
paarppavar	பார்ப்பவர்
paarththu	பார்த்து
parppavar	பற்பவர்
vaelaiyaaga	வேளையாக
vaelaiyaaka	வேலையாக
vealaiyaaka	வேளையாக
vaelaiyin	வேலையினின்
vealaiyin	வேளையின்
vaelaiyil	வேலையில்
vealaiyil	வேளையில்
vaelaiyaiyum	வேலையையும்
vealaiyaiyum	வேளையையும்
vai	வை
vaiguntarin	வைக்குண்டறின்
vaikundarin	வைக்குண்டரின்
vaiguntar	வேகுண்டர்
vaikundar	வேக்குண்டரர்
vaiththiyanaatha	வைத்தியனாதாத
vaiththiyanaathan	வைத்தியநாதன்
vaibavam	வைபவம்
vaipavam	வைபவமம்
volga	கல்கால்கா
volgaa	வல்காாாா
voolga	வால்கால்க்்
voolka	வோல்க்கா்கா்க
vooulga	வுல்க
voulga	வுல்கால்கா்க
vouulga	வ்க்லா்கால்க்
wolga	வவோ்கால்கால்கால்கால்கால்கால்்கா
wolgaa	வால்காா
woolga	வால்கால்கா்க்்
woolgaa	வோல்கா
woulga	வால்கால்்
shaam	சாம்சாம்
sham	ஷம்ஷ்ம்
shaavai	வோ
shahvai	சாவ்வை
shavai	சேச
escotch	ஸ்டாட்ச்
scotch	ச்சாட்ச்டா
skaatch	சாகாகாட்சாட்ச்ச்ச்ச்ச்ச்ச்ச்ச்ச்
skoch	ஸ்கோச்சோச்சுச்சோச்ச்சுக்ஷ்
skotch	க்சுச்ச்ச்ச்ச்ச்ச்ச்ச்ச்ச்ச்ச்ச்
sqoch	ச்சோச்ச்
sqotch	ஸ்காட்ச்ச்ச்ச்ச்ச்ச்ச்ச்ச்ச்ச்ச்
scotlaanththin	ச்கொட்லாந்தின்
scotlandin	ஸ்கொட்லாண்டின்
skaatlaandhin	ஸ்காட்லாந்தின்
sthaabaga	ஸ்தாபகபாக
sthaapaga	ஸ்தாபகபககககககக
shreenivaachan	ஸ்ரீனிவாசன்
sreenivaasan	ஸ்ரீனிவாசன்
srinivaachan	சுரினிவாசன்
srinivaasan	சுரினிவாசன்
srinivasan	சுரினிவசனனன்
shreerangkaththil	சர்ரீரங்கத்தில்
sreerankaththil	சர்ரீங்கத்தில்
srirangaththil	சர்ரீரங்கத்தில்
sriranggaththil	சர்ரீரங்கத்தில்
srirangkaththil	சர்ரீரங்கத்தில்
hangaran	ஹங்கரனான்
hangarian	நன்கரியானன்
hankeeriyan	நன்கேறியன்
hungaran	ஹுங்கரரனன்
hungarian	நுங்கரியான்
huungarian	நோங்கரியானன்
hanggaeriyil	கங்கேறியில்
hankeariyil	கங்கேறியில்
hungaeriyil	புங்கேறியில்
hungaryil	குங்கறியில்
hungaryyil	புங்கறியில்
harijan	ஹரிசன்
paattar	பாட்டறர்
paatter	அத்தர்
pattar	பட்டார்
potter	பொட்டெர்
haaris	ஷிசி
hairis	சிசிச்ரிச்சிரிச்
hairiss	சிசிஸ்
hares	ஆசேசார்ஜ்சரஸ்சர்ஜ்சர்ஸ்சர்ஸ்சர்ஸ
haris	சிசிஸ்
hariz	ஜிஜ்ஜி
harres	ஷாரஸ்சரசசாரஸ்சரசேஸ்ரசேசரஸ்
harrij	ிஜிசிரிஜ்ஜி
harris	ிறிஷிஸ்
harriss	ேஸ்ரசஷ்
harriz	ிஷிஜி
heriss	நாசிஸ்ஸ்
hael	ஹ
hel	ஹ
hell	எல்
haidroa	ரெட்டோரா
haitrao	த்ற்றூ
hydro	ஞ்ட்ரூ
haithar	ஹைத்ரர்
hyder	ஹிட்டர்
